Lynn's area
You entered the area where Lynn excercises. You see the Living room to the south, and a couch to the north.

You can see Lynn and Lynn's hair here.

Loud House 'game on'
An Interactive Fiction by Caleb Wilson
Release 1 / Serial number 210525 / Inform 7 build 6M62 (I6/v6.33 lib 6/12N) SD

Lynn's area
You entered the area where Lynn excercises. You see the Living room to the south, and a couch to the north.

You can see Lynn and Lynn's hair here.

I beg your pardon?

>l
Starting Room
This is the description of the starting room.

* * *

I beg your pardon?

>n
Living room
You are in the Living room. You see Lynn to the north, Lola and Lana to the south, stairs to the west, and the exit to the east.

>e
Royal Woods Main Street
You can see a video game shop to the north, your house to the west, and the schools to the south.

>n
video game shop
You are in the video game shop. Here you can buy that video game + collectable rare cards for just $45!

You can see an owner and Locked safe 4 (closed) here.

>w
Test room

>s
You can't go that way.

* * *

I beg your pardon?

I beg your pardon?

>e
You can't go that way.

>e
You can't go that way.

I beg your pardon?

* * *

>e
You can't go that way.

>ee
That's not a verb I recognise.

I beg your pardon?

* * *

Lynn's area
You entered the area where Lynn excercises. You see the Living room to the south, and a couch to the north.

You can see Lynn and Lynn's hair here.

Loud House 'game on'
An Interactive Fiction by Caleb Wilson
Release 1 / Serial number 210525 / Inform 7 build 6M62 (I6/v6.33 lib 6/12N) SD

Lynn's area
You entered the area where Lynn excercises. You see the Living room to the south, and a couch to the north.

You can see Lynn and Lynn's hair here.

>duck
should be a fake duck now.

I beg your pardon?

* * *

>l
Starting Room
This is the description of the starting room.

>l
Starting Room
This is the description of the starting room.

* * *

Lynn's area
You entered the area where Lynn excercises. You see the Living room to the south, and a couch to the north.

You can see Lynn and Lynn's hair here.

Loud House 'game on'
An Interactive Fiction by Caleb Wilson
Release 1 / Serial number 210525 / Inform 7 build 6M62 (I6/v6.33 lib 6/12N) SD

Lynn's area
You entered the area where Lynn excercises. You see the Living room to the south, and a couch to the north.

You can see Lynn and Lynn's hair here.

>l
Lynn's area
You entered the area where Lynn excercises. You see the Living room to the south, and a couch to the north.

You can see Lynn and Lynn's hair here.

video game shop
You are in the video game shop. Here you can buy that video game + collectable rare cards for just $45!

You can see an owner and Locked safe 4 (closed) here.

I beg your pardon?

* * *

>l
Lynn's area
You entered the area where Lynn excercises. You see the Living room to the south, and a couch to the north.

You can see Lynn and Lynn's hair here.

video game shop
You are in the video game shop. Here you can buy that video game + collectable rare cards for just $45!

You can see an owner and Locked safe 4 (closed) here.

>s
You can't go that way.

>n
hallway
Now you are in the hallway.  You can go back south, or west to Lynn's and Lucy's room or east to Lisa's and Lily's room or north for northern hallway.

>n
north hall
You are in north hall. you see Lori's and Leni's room to the east, Luan's and Luna's room to the west, hallway to the south, and far north hall to the north.

>n
far north hall
You are in far north hall. You see Lola's and Lana's room to the west, stairs to the east, and north hall to the south.

>d
You can't go that way.

>e
Living room
You are in the Living room. You see Lynn to the north, Lola and Lana to the south, and stairs to the west.

>s
You can't go that way.

>e
You can't go that way.

>n
Lynn's area
You entered the area where Lynn excercises. You see the Living room to the south.

You can see Lynn and Lynn's hair here.

>get hair
Taken.

>s
Living room
You are in the Living room. You see Lynn to the north, Lola and Lana to the south, and stairs to the west.

>w
far north hall
You are in far north hall. You see Lola's and Lana's room to the west, stairs to the east, and north hall to the south.

>w
Lola's and Lana's room
You enter Lola's and Lana's room. You see far north hall to the east.

You can see a mirror, a teacup and a frog cage here.

>e
far north hall
You are in far north hall. You see Lola's and Lana's room to the west, stairs to the east, and north hall to the south.

>s
north hall
You are in north hall. you see Lori's and Leni's room to the east, Luan's and Luna's room to the west, hallway to the south, and far north hall to the north.

>s
hallway
Now you are in the hallway.  You can go back south, or west to Lynn's and Lucy's room or east to Lisa's and Lily's room or north for northern hallway.

>e
Lisa's and Lily's room
Now you are in Lisa's and Lily's room. You see Lisa working on a device and Lily in her crib.

You can see Lisa here.

>l
Lisa's and Lily's room
Now you are in Lisa's and Lily's room. You see Lisa working on a device and Lily in her crib.

You can see Lisa here.

* * *

>i
You are carrying:
  Lynn's hair

* * *

>l
Lynn's area
You entered the area where Lynn excercises. You see the Living room to the south, and a couch to the north.

You can see Lynn and Lynn's hair here.

video game shop
You are in the video game shop. Here you can buy that video game + collectable rare cards for just $45!

You can see an owner and Locked safe 4 (closed) here.

>i
You are carrying nothing.

>n
hallway
Now you are in the hallway.  You can go back south, or west to Lynn's and Lucy's room or east to Lisa's and Lily's room or north for northern hallway.

>w
Lynn's and Lucy's room
Now you are in Lynn's and Lucy's room. Only Lucy is inside. The only way out is back east.

You can see a coffin (in which is Quarter 1) here.

>get all
coffin: Taken.
Quarter 1: Taken.

>l
Lynn's and Lucy's room
Now you are in Lynn's and Lucy's room. Only Lucy is inside. The only way out is back east.

>x lucy
You can't see any such thing.

>l
Lynn's and Lucy's room
Now you are in Lynn's and Lucy's room. Only Lucy is inside. The only way out is back east.

* * *

>x lucy
You can't see any such thing.

>e
hallway
Now you are in the hallway.  You can go back south, or west to Lynn's and Lucy's room or east to Lisa's and Lily's room or north for northern hallway.

>e
Lisa's and Lily's room
Now you are in Lisa's and Lily's room. You see Lisa working on a device and Lily in her crib.

You can see Lisa here.

>talk to lisa
"I am working on a device to turn a regular kid into an athlete! It requires DNA from someone who's good at sports, though." Now where can you find an athlete kid that's good at sports?

>x lisa
She is wearing glasses and a light green jacket.

>l
Lisa's and Lily's room
Now you are in Lisa's and Lily's room. You see Lisa working on a device and Lily in her crib.

You can see Lisa here.

>w
hallway
Now you are in the hallway.  You can go back south, or west to Lynn's and Lucy's room or east to Lisa's and Lily's room or north for northern hallway.

>n
north hall
You are in north hall. you see Lori's and Leni's room to the east, Luan's and Luna's room to the west, hallway to the south, and far north hall to the north.

>w
Luan's and Luna's room
You are in Luan's and Luna's room. You see north hall to the east.

You can see Luan, Luna, a puppet and a speaker here.

>talk to luan
You try to ask Luan for advice on how to make money, but she inturupts with a joke. "why did the chicken cross the road? To prove it wasn't a chicken!" She laughs at her own joke.

>talk to luan
You try to ask Luan for advice on how to make money, but she inturupts with a joke. "why did the chicken cross the road? To prove it wasn't a chicken!" She laughs at her own joke.

>x luan
She is wearing a dress with a  yellow bottom to it and a squirt flower at the top of the dress.

>talk to luna
You ask Luna for advice on how to make money, and she says, "You know, if I were you, I'd try searching the ENTIRE house for clues and Quarters." She goes back to playing her guitar.

>e
north hall
You are in north hall. you see Lori's and Leni's room to the east, Luan's and Luna's room to the west, hallway to the south, and far north hall to the north.

>e
Lori's and Leni's room
 You see north hall to the west.

All you see are Leni's bed, Lori's bed and a dresser.

>x leni bed
You can't see any such thing.

>x leni's bed
You check Leni's bed, but all you see are clothes and dolls.

>x lori's bed
You check Lori's bed, and you find Lori's phone.

On Lori's bed is Lori's phone.

>x phone
You turn on Lori's phone, and you see an advertisement for proffessional kids football. It says that only athletes 10 to 15 (of course, you're 11) can enter. it's a $1 entry fee, and if you win, you'll earn $500! You should keep that in mind. Just collect 4 Quarters and become an athlete to enter.

>take all
dresser: Taken.
Lori's phone: Taken.
Quarter 2: Taken.

>l
Lori's and Leni's room
 You see north hall to the west.

All you see are Leni's bed and Lori's bed.

>x dresser
The dresser is empty.

>l on dresser
You can't see any such thing.

>l
Lori's and Leni's room
 You see north hall to the west.

All you see are Leni's bed and Lori's bed.

>w
north hall
You are in north hall. you see Lori's and Leni's room to the east, Luan's and Luna's room to the west, hallway to the south, and far north hall to the north.

>i
You are carrying:
  Quarter 2
  Lori's phone
  a dresser
  Quarter 1
  a coffin

>n
far north hall
You are in far north hall. You see Lola's and Lana's room to the west, stairs to the east, and north hall to the south.

>w
Lola's and Lana's room
You enter Lola's and Lana's room. You see far north hall to the east.

You can see a mirror, a teacup and a frog cage here.

>x cage
You look in the frog cage and find a Quarter! But Hops the frog won't let you take it. Mabey you should check a place that IS'NT a pet cage.

>x mirror
You look in the mirror, and... Bingo! You see a coin in the frog cage, and a bundle of cash in the teacup!

>x teacup
You check the teacup, and you find a bundle of cash! But you can't take that. It's Lola's, and if she found out, she would do anything to make your life miserable.

>get cash
You can't see any such thing.

>l
Lola's and Lana's room
You enter Lola's and Lana's room. You see far north hall to the east.

You can see a mirror, a teacup and a frog cage here.

>n
You can't go that way.

>e
far north hall
You are in far north hall. You see Lola's and Lana's room to the west, stairs to the east, and north hall to the south.

>e
Living room
You are in the Living room. You see Lynn to the north, Lola and Lana to the south, and stairs to the west.

>n
Lynn's area
You entered the area where Lynn excercises. You see the Living room to the south.

You can see Lynn and Lynn's hair here.

* * *

>get hair
Taken.

>x lynn
She is wearing her sports uniform, which her player number is 1( which stands for her being number 1 at all the sports ).

>talk to lynn
She says, "I'm trying to excercise for my football game. I've been excercising for about 5 hours streight." You ask her both how she hasn't gotten tired, and why she hasn't used the bathroom for 5 hours. She answers with "1, I don't really get tired unless it's night time, and 2, it's bad luck to use the bathroom before a football game- if I go number 2, I can't be number 1." You see her excercise so hard that a bit of her hair falls off.

>s
Living room
You are in the Living room. You see Lynn to the north, Lola and Lana to the south, and stairs to the west.

>s
South Living room
You see Living room to the north and the basement stairs to the south.

You can see Lola, and

You can see Lana here.

>talk to lola
You can't see any such thing.

>talk to lana
She says, "You know, I learned how to plumb, like the taste of mud, and how to repair cars through Lori's phone- maybey you should check her phone, too." She goes back to repairing Lola's go-kart.

>l
South Living room
You see Living room to the north and the basement stairs to the south.

You can see Lola, and

You can see Lana here.

>i
You are carrying:
  Lynn's hair
  Quarter 2
  Lori's phone
  a dresser
  Quarter 1
  a coffin

>l
South Living room
You see Living room to the north and the basement stairs to the south.

You can see Lola, and

You can see Lana here.

>e
You can't go that way.

>l
South Living room
You see Living room to the north and the basement stairs to the south.

You can see Lola, and

You can see Lana here.

>w
You can't go that way.

>e
You can't go that way.

>n
Living room
You are in the Living room. You see Lynn to the north, Lola and Lana to the south, and stairs to the west.

>s
South Living room
You see Living room to the north and the basement stairs to the south.

You can see Lola, and

You can see Lana here.

>s
You can't go that way.

>n
Living room
You are in the Living room. You see Lynn to the north, Lola and Lana to the south, and stairs to the west.

>n
Lynn's area
You entered the area where Lynn excercises. You see the Living room to the south.

You can see Lynn here.

>s
Living room
You are in the Living room. You see Lynn to the north, Lola and Lana to the south, and stairs to the west.

* * *

>w
far north hall
You are in far north hall. You see Lola's and Lana's room to the west, stairs to the east, and north hall to the south.

>s
north hall
You are in north hall. you see Lori's and Leni's room to the east, Luan's and Luna's room to the west, hallway to the south, and far north hall to the north.

* * *

>e
Lisa's and Lily's room
Now you are in Lisa's and Lily's room. You see Lisa working on a device and Lily in her crib.

You can see Lisa here.

>give hair to lisa
Lisa is excited that you gave her Lynn's hair, and she blasts you with the athlete ray.

>i
You are carrying:
  Quarter 2
  Lori's phone
  a dresser
  Quarter 1
  a coffin

* * *

>l
Lynn's area
You entered the area where Lynn excercises. You see the Living room to the south, and a couch to the north.

You can see Lynn and Lynn's hair here.

video game shop
You are in the video game shop. Here you can buy that video game + collectable rare cards for just $45!

You can see an owner and Locked safe 4 (closed) here.

>give quarters to lola
Lola is excited and hands you a dollar bill.

>n
Living room
You are in the Living room. You see Lynn to the north, Lola and Lana to the south, stairs to the west, and the exit to the east.

* * *

>e
Royal Woods Main Street
You can see a video game shop to the north, your house to the west, and the schools to the south.

>s
Royal Woods School Grounds
These bullies come to stop you from entering unless you give them money. You see the inside of the school to the south, and Royal Woods Main Street to the north.

You can see Bully and Locked safe 3 (closed) here.

>give dollar to bully
"Come on in," said the Bully. "Oh, and, the football stadium is above here."

You aren't holding the Dollar Bill.

>u
Football Stadium
The Football game is about to start, and guess who your playing against- Lynn! She says "Wow, Lincoln! I didn't know that you were coming to the same football game as me!"

You can see a ball and a Scoring post here.

>get ball
Taken.

>throw ball at post
You throw the ball into the scoring post, and you won the game! The same bully from earlier hands you $500. You decide to split it evenly between your ten sisters- that means 45.45 each- exactly enough!

You aren't holding the ball.

* * *

>l
Lynn's area
You entered the area where Lynn excercises. You see the Living room to the south, and a couch to the north.

You can see Lynn and Lynn's hair here.

video game shop
You are in the video game shop. Here you can buy that video game + collectable rare cards for just $45!

You can see an owner and Locked safe 4 (closed) here.

>x cards
You see nothing special about collectable cards.

>n
Royal Woods Main Street
You can see a video game shop to the north, your house to the west, and the schools to the south.

>restart
Are you sure you want to restart?

>y
South Living room
You see Living room to the north and the basement stairs to the south.

You can see Lola and Lana here.

Man-cave
You can leave the Man-cave by going up.

You can see a space key here.

Royal Woods School Grounds
These bullies come to stop you from entering unless you give them money. You see the inside of the school to the south, and Royal Woods Main Street to the north.

You can see Bully and Locked safe 3 (closed) here.

Loud House 'game on'
An Interactive Fiction by Caleb Wilson
Release 1 / Serial number 210511 / Inform 7 build 6M62 (I6/v6.33 lib 6/12N) SD

Royal Woods School Grounds
These bullies come to stop you from entering unless you give them money. You see the inside of the school to the south, and Royal Woods Main Street to the north.

You can see Bully and Locked safe 3 (closed) here.

>n
Royal Woods Main Street
You can see a video game shop to the north, your house to the west, and the schools to the south.

* * *

>l
Lynn's area
You entered the area where Lynn excercises. You see the Living room to the south, and a couch to the north.

You can see Lynn and Lynn's hair here.

video game shop
You are in the video game shop. Here you can buy that video game + collectable rare cards for just $45!

You can see an owner and Locked safe 4 (closed) here.

>l
video game shop
You are in the video game shop. Here you can buy that video game + collectable rare cards for just $45!

You can see an owner and Locked safe 4 (closed) here.

video game shop
You are in the video game shop. Here you can buy that video game + collectable rare cards for just $45!

You can see an owner and Locked safe 4 (closed) here.

>n
Royal Woods Main Street
You can see a video game shop to the north, your house to the west, and the schools to the south.

>n
video game shop
You are in the video game shop. Here you can buy that video game + collectable rare cards for just $45!

You can see an owner and Locked safe 4 (closed) here.

>s
Royal Woods Main Street
You can see a video game shop to the north, your house to the west, and the schools to the south.

>s
Royal Woods School Grounds
These bullies come to stop you from entering unless you give them money. You see the inside of the school to the south, and Royal Woods Main Street to the north.

You can see Bully and Locked safe 3 (closed) here.

>u
Football Stadium
The Football game is about to start, and guess who your playing against- Lynn! She says "Wow, Lincoln! I didn't know that you were coming to the same football game as me!"

You can see a ball and a Scoring post here.

>throw ball at post
(first taking the ball)
You throw the ball into the scoring post, and you won the game! The same bully from earlier hands you $500. You decide to split it evenly between your ten sisters- that means $45 each- exactly enough!

You aren't holding the ball.

>d
Royal Woods School Grounds
These bullies come to stop you from entering unless you give them money. You see the inside of the school to the south, and Royal Woods Main Street to the north.

You can see Bully and Locked safe 3 (closed) here.

>n
Royal Woods Main Street
You can see a video game shop to the north, your house to the west, and the schools to the south.

* * *

>n
video game shop
You are in the video game shop. Here you can buy that video game + collectable rare cards for just $45!

You can see an owner and Locked safe 4 (closed) here.

>give $45 to owner
"Thank you for buying from Royal Woods Video Game shop," said the owner. "oh, and don't forget that you can play your video game in the room under the room under the basement."

You aren't holding $45.

>x card
You can't see any such thing.

>x cards
You see nothing special about collectable cards.

>s
Royal Woods Main Street
You can see a video game shop to the north, your house to the west, and the schools to the south.

* * *

>l
video game shop
You are in the video game shop. Here you can buy that video game + collectable rare cards for just $45!

You can see an owner and Locked safe 4 (closed) here.

video game shop
You are in the video game shop. Here you can buy that video game + collectable rare cards for just $45!

You can see an owner and Locked safe 4 (closed) here.

>talk to owner
Testing.

video game shop
You are in the video game shop. Here you can buy that video game + collectable rare cards for just $45!

You can see an owner and Locked safe 4 (closed) here.

>talk to owner
Testing.

video game shop
You are in the video game shop. Here you can buy that video game + collectable rare cards for just $45!

You can see an owner and Locked safe 4 (closed) here.

I beg your pardon?

* * *

>l
Lynn's area
You entered the area where Lynn excercises. You see the Living room to the south, and a couch to the north.

You can see Lynn and Lynn's hair here.

video game shop
You are in the video game shop. Here you can buy that video game + collectable rare cards for just $45!

You can see an owner and Locked safe 4 (closed) here.

>n
Royal Woods Main Street
You can see a video game shop to the north, your house to the west, and the schools to the south.

!!!

>s
Royal Woods School Grounds
These bullies come to stop you from entering unless you give them money. You see the inside of the school to the south, and Royal Woods Main Street to the north.

You can see Bully and Locked safe 3 (closed) here.

* * *

Lynn's area
You entered the area where Lynn excercises. You see the Living room to the south, and a couch to the north.

You can see Lynn and Lynn's hair here.

Loud House 'game on'
An Interactive Fiction by Caleb Wilson
Release 1 / Serial number 210525 / Inform 7 build 6M62 (I6/v6.33 lib 6/12N) SD

Lynn's area
You entered the area where Lynn excercises. You see the Living room to the south, and a couch to the north.

You can see Lynn and Lynn's hair here.

>s
living room
You are in the living room. You see Lynn to the north, Lola and Lana to the south, stairs to the west, and the exit to the east.

>n
You can't go that way.

>s
South Room
Now you are in the South Room.  You can go back north, or down.

You can see a quarter here.

>d
Lower Room
Now you are in the Lower Room.  The only way out is back up.

You can see Lionel here.

>talk to lionel
That's not a verb I recognise.

* * *

>s
South Room
Now you are in the South Room.  You can go back north, or down.

You can see a quarter here.

>x quarter
You see nothing special about the quarter.

>get quarter
Taken.

>d
Lower Room
Now you are in the Lower Room.  The only way out is back up.

You can see Lionel here.

>x quarter
You see nothing special about the quarter.

>u
South Room
Now you are in the South Room.  You can go back north, or down.

>i
You are carrying:
  a quarter

>d
Lower Room
Now you are in the Lower Room.  The only way out is back up.

You can see Lionel here.

>x lionel
You see nothing special about Lionel.

>l
Lower Room
Now you are in the Lower Room.  The only way out is back up.

You can see Lionel here.

>u
South Room
Now you are in the South Room.  You can go back north, or down.

>n
Starting Room
This is the description of the starting room.  You can go south.

* * *

>n
You can't go that way.

>d
You can't go that way.

>l
Starting Room
This is the description of the starting room.  You can go south.

>s
South Room
Now you are in the South Room.  You can go back north, or down.

You can see a quarter here.

* * *

>x quarter
You see nothing special about the quarter.

>l
South Room
Now you are in the South Room.  You can go back north, or down.

You can see a quarter here.

>take quarter
Taken.

>i
You are carrying:
  a quarter

>drop quarter
Dropped.

>l
South Room
Now you are in the South Room.  You can go back north, or down.

You can see a quarter here.

>d
Lower Room
Now you are in the Lower Room.  The only way out is back up.

You can see Lionel here.

* * *

>x lionel
You see nothing special about Lionel.

>u
South Room
Now you are in the South Room.  You can go back north, or down.

You can see a quarter here.

* * *

>n
You can't go that way.

>n
Living room
You are in the Living room. You see Lynn to the north, Lola and Lana to the south, stairs to the west, and the exit to the east.

* * *

>e
Royal Woods Main Street
You can see a video game shop to the north, your house to the west, and the schools to the south.

>s
Royal Woods School Grounds
These bullies come to stop you from entering unless you give them money. You see the inside of the school to the south, and Royal Woods Main Street to the north.

You can see Bully here.

>x Bully
He is holding a jar of money, and he wants you to give him a dollar bill to pass through.

>u
Football Stadium
The Football game is about to start, and guess who your playing against- Lynn! She says "Wow, Lincoln! I didn't know that you were coming to the same football game as me!"

You can see a ball here.

>take ball
Taken.

>throw ball
Dropped.

>take ball
Taken.

>l
Football Stadium
The Football game is about to start, and guess who your playing against- Lynn! She says "Wow, Lincoln! I didn't know that you were coming to the same football game as me!"

>pass ball to Lynn
That's not a verb I recognise.

>give ball to Lynn
You can't see any such thing.

* * *

>n
Living room
You are in the Living room. You see Lynn to the north, Lola and Lana to the south, stairs to the west, and the exit to the east.

>w
far north hall
You are in far north hall. You see Lola's and Lana's room to the west, stairs to the east, and north hall to the south.

* * *

>s
north hall
You are in north hall. you see Lori's and Leni's room to the east, Luan's and Luna's room to the west, hallway to the south, and far north hall to the north.

>u
Secret Attic

* * *

>n
You can't go that way.

>w
Lynn's and Lucy's room
Now you are in Lynn's and Lucy's room. Only Lucy is inside. The only way out is back east.

You can see a coffin (in which is Quarter 1) here.

>get quarter
Taken.

>e
hallway
Now you are in the hallway.  You can go back south, or west to Lynn's and Lucy's room or east to Lisa's and Lily's room or north for northern hallway.

* * *

>e
Lisa's and Lily's room
Now you are in Lisa's and Lily's room. You see Lisa working on a device and Lily in her crib.

You can see Lisa here.

>w
hallway
Now you are in the hallway.  You can go back south, or west to Lynn's and Lucy's room or east to Lisa's and Lily's room or north for northern hallway.

>d
You can't go that way.

>s
Your Room
You need money to buy a video game.  You can go north to the hallway.

>s
You can't go that way.

* * *

>n
far north hall
You are in far north hall. You see Lola's and Lana's room to the west, stairs to the east, and north hall to the south.

>n
You can't go that way.

* * *

>d
You can't go that way.

>s
north hall
You are in north hall. you see Lori's and Leni's room to the east, Luan's and Luna's room to the west, hallway to the south, and far north hall to the north.

>e
Lori's and Leni's room
 You see north hall to the west.

All you see are Leni's bed, Lori's bed and a dresser.

>w
north hall
You are in north hall. you see Lori's and Leni's room to the east, Luan's and Luna's room to the west, hallway to the south, and far north hall to the north.

>w
Luan's and Luna's room
You are in Luan's and Luna's room. You see north hall to the east.

You can see Luan, Luna, a puppet and a speaker here.

>d
You can't go that way.

>e
north hall
You are in north hall. you see Lori's and Leni's room to the east, Luan's and Luna's room to the west, hallway to the south, and far north hall to the north.

>d
You can't go that way.

>n
far north hall
You are in far north hall. You see Lola's and Lana's room to the west, stairs to the east, and north hall to the south.

* * *

>e
Living room
You are in the Living room. You see Lynn to the north, Lola and Lana to the south, and stairs to the west.

>d
You can't go that way.

>n
Lynn's area
You entered the area where Lynn excercises. You see the Living room to the south.

You can see Lynn and Lynn's hair here.

* * *

>get hair
Taken.

>w
You can't go that way.

>n
You can't go that way.

>w
You can't go that way.

* * *

>n
You can't go that way.

>s
Living room
You are in the Living room. You see Lynn to the north, Lola and Lana to the south, and stairs to the west.

* * *

>s
hallway
Now you are in the hallway.  You can go back south, or west to Lynn's and Lucy's room or east to Lisa's and Lily's room or north for northern hallway.

>s
Your Room
You need money to buy a video game.  You can go north to the hallway.

I beg your pardon?

>n
hallway
Now you are in the hallway.  You can go back south, or west to Lynn's and Lucy's room or east to Lisa's and Lily's room or north for northern hallway.

>e
Lisa's and Lily's room
Now you are in Lisa's and Lily's room. You see Lisa working on a device and Lily in her crib.

You can see Lisa here.

>give quarter to lisa
Lisa doesn't seem interested.

>give hair to lisa
Xyz 2
Lisa doesn't seem interested.

* * *

>n
You can't go that way.

>l
Man-cave
You can leave the Man-cave by going up.

You can see a space key here.

>u
Swellview
Oh no! There's now an alien invasion from Mars! Go down to enter the Man-Cave, or go west to enter the rocket and get to Mars.

You can see a rocket and Marty here.

>n
You can't go that way.

>s
You can't go that way.

>n
You can't go that way.

>w
(first opening the rocket)
It seems to be locked.

>e
You can't go that way.

>d
Man-cave
You can leave the Man-cave by going up.

You can see a space key here.

>e
Nickolodeon game
You can play the Spongebob game to the north, Alvin and the chipmunks to the south, Henry Danger to the west, and Teenage Mutant Ninja Turtles to the east. Go up twice to leave.

You can see Game Gate here.

>u
Secret Passageway
So, I guess you found my secret room. Either you beat the game, or you found a hack to it. If the first one, good job! Well, you know where to go from here.

>u
Basement
You see Lola and Lana to the north.

You can see Couch 2 and a Video game concle here.

>n
South Living room
You see Living room to the north and the basement stairs to the south.

You can see Lola and Lana here.

>x lola
She is wearing a pink dress and a tiara.

* * *

>s
living room
You are in the living room. You see Lynn to the north, Lola and Lana to the south, stairs to the west, and the exit to the east.

>l
South Room
Now you are in the South Room.  You can go back north, or down.

You can see a quarter here.

>s
You can't go that way.

I beg your pardon?

>s
You can't go that way.

>n
Starting Room
This is the description of the starting room.  You can go south.

>s
South Room
Now you are in the South Room.  You can go back north, or down.

>d
Lower Room
Now you are in the Lower Room.  The only way out is back up.

You can see Lionel here.

* * *

>s
You can't go that way.

>d
Lower Room
Now you are in the Lower Room.  The only way out is back up.

You can see Lionel here.

>u
Ok!

>u
You can't go that way.

* * *

>x
What do you want to examine?

>l
Starting Room
This is the description of the starting room.  You can go south.

* * *

>x
(the quarter)
You see nothing special about the quarter.

>x quarter
You see nothing special about the quarter.

* * *

>n
You can't go that way.

* * *

>s
You can't go that way.

* * *

>d
Lower Room
Now you are in the Lower Room.  The only way out is back up.

You can see Lionel here.

>l
Lower Room
Now you are in the Lower Room.  The only way out is back up.

You can see Lionel here.

* * *

>s
living room
You are in the living room. You see Lynn to the north, Lola and Lana to the south, stairs to the west, and the exit to the east.

>d
Secret Passageway
So, I guess you found my secret room. Either you beat the game, or you found a hack to it. If the first one, good job! Well, you know where to go from here.

>x lionel
You see nothing special about Lionel.

* * *

>d
Secret Passageway
So, I guess you found my secret room. Either you beat the game, or you found a hack to it. If the first one, good job! Well, you know where to go from here.

>l
Lower Room
Now you are in the Lower Room.  The only way out is back up.

You can see Lionel here.

>l
Lower Room
Now you are in the Lower Room.  The only way out is back up.

You can see Lionel here.

* * *

>d
Secret Passageway
So, I guess you found my secret room. Either you beat the game, or you found a hack to it. If the first one, good job! Well, you know where to go from here.

>u
Basement
You see Lola and Lana to the north.

You can see Couch 2 and a Video game concle here.

* * *

>n
South Living room
You see Living room to the north and the basement stairs to the south.

You can see Lola and Lana here.

>n
Living room
You are in the Living room. You see Lynn to the north, Lola and Lana to the south, stairs to the west, and the exit to the east.

* * *

>s
hallway
Now you are in the hallway.  You can go back south, or west to Lynn's and Lucy's room or east to Lisa's and Lily's room or north for northern hallway.

>e
Lisa's and Lily's room
Now you are in Lisa's and Lily's room. You see Lisa working on a device and Lily in her crib.

You can see Lisa and Locked safe (closed) here.

>open Locked safe
It seems to be locked.

* * *

>d
Secret Passageway
So, I guess you found my secret room. Either you beat the game, or you found a hack to it. If the first one, good job! Well, you know where to go from here.

>d
Nickolodeon game
You can play the Spongebob game to the north, Alvin and the chipmunks to the south, Henry Danger to the west, and Teenage Mutant Ninja Turtles to the east. Go up twice to leave.

>u
Secret Passageway
So, I guess you found my secret room. Either you beat the game, or you found a hack to it. If the first one, good job! Well, you know where to go from here.

* * *

>n
South Living room
You see Living room to the north and the basement stairs to the south.

You can see Lola and Lana here.

>i
You are carrying:
  Quarter 4
  Quarter 2
  Quarter 3
  Quarter 1

* * *

>d
Nickolodeon game
You can play the Spongebob game to the north, Alvin and the chipmunks to the south, Henry Danger to the west, and Teenage Mutant Ninja Turtles to the east. Go up twice to leave.

>n
Pineapple house
You can go north.

You can see Gary here.

>n
Bikini Bottom
you  see your Pineapple house to the south and the Krusty Krab to the north.

You can see Plankton's robot here.

>s
Pineapple house
You can go north.

You can see Gary here.

>s
Nickolodeon game
You can play the Spongebob game to the north, Alvin and the chipmunks to the south, Henry Danger to the west, and Teenage Mutant Ninja Turtles to the east. Go up twice to leave.

>u
Secret Passageway
So, I guess you found my secret room. Either you beat the game, or you found a hack to it. If the first one, good job! Well, you know where to go from here.

* * *

>n
South Living room
You see Living room to the north and the basement stairs to the south.

You can see Lola and Lana here.

>s
Basement
You see Lola and Lana to the north.

You can see Couch 2 and a Video game concle here.

>n
South Living room
You see Living room to the north and the basement stairs to the south.

You can see Lola and Lana here.

* * *

>s
Royal Woods School Grounds
These bullies come to stop you from entering unless you give them money. You see the inside of the school to the south, and Royal Woods Main Street to the north.

You can see Bully and Locked safe 3 (closed) here.

>take $45
You can't see any such thing.

>i
You are carrying:
  Quarter 4
  Quarter 2
  Quarter 3
  Quarter 1

* * *

>n
Bikini Bottom
you  see your Pineapple house to the south and the Krusty Krab to the north.

You can see Plankton's robot here.

>n
Krusty Krab
You see Bikini Bottom to the south.

You can see mister Krabs, Locked safe 5 (closed) and Krabby Patty dresser (in which is Dollar Bill 2) here.

>s
Bikini Bottom
you  see your Pineapple house to the south and the Krusty Krab to the north.

You can see Plankton's robot here.

>x Planktons robot
You can't see any such thing.

>x Plankton's robot
You see nothing special about Plankton's robot.

* * *

>n
Krusty Krab
You see Bikini Bottom to the south.

You can see mister Krabs, Locked safe 5 (closed) and Krabby Patty dresser (in which is Dollar Bill 2) here.

>take Dollar Bill 2
Taken.

>give Dollar Bill to mister Krabs
mister Krabs's eyes show dollar sighns and he hands you a Krabby Patty.

You aren't holding Dollar Bill 2.

>i
You are carrying:
  Krabby Patty
  Quarter 4
  Quarter 2
  Quarter 3
  Quarter 1

>s
Bikini Bottom
you  see your Pineapple house to the south and the Krusty Krab to the north.

You can see Plankton's robot here.

* * *

>take Dollar Bill 2
Taken.

>give Dollar Bill 2 to mister Krabs
mister Krabs's eyes show dollar sighns and he hands you a Krabby Patty.

You aren't holding Dollar Bill 2.

>i
You are carrying:
  Krabby Patty
  Quarter 4
  Quarter 2
  Quarter 3
  Quarter 1

* * *

>s
Bikini Bottom
you  see your Pineapple house to the south and the Krusty Krab to the north.

You can see Plankton's robot here.

>throw Krabby Patty at Plankton's robot
you throw the Krabby Patty at the robot, and you've saved Bikini Bottom!

You aren't holding Krabby Patty.

>s
Pineapple house
You can go north.

You can see Gary here.

* * *

>n
Bikini Bottom
you  see your Pineapple house to the south and the Krusty Krab to the north.

You can see Plankton's robot here.

I beg your pardon?

>n
Krusty Krab
You see Bikini Bottom to the south.

You can see mister Krabs, Locked safe 5 (closed) and Krabby Patty dresser here.

* * *

>n
Pineapple house
You can go north.

You can see Gary here.

>north
You can't go that way.

>north
You can't go that way.

* * *

>n
Pineapple house
You can go north.

You can see Gary here.

>s
You can't go that way.

* * *

>e
You can't go that way.

>w
You can't go that way.

* * *

>d
Nickolodeon game
You can play the Spongebob game to the north, Alvin and the chipmunks to the south, Henry Danger to the west, and Teenage Mutant Ninja Turtles to the east. Go up twice to leave.

>w
Man-cave
You can leave the Man-cave by going up.

>u
Swellview
Oh no! There's now an alien invasion from Mars! Go down to enter the Man-Cave.

You can see Martian here.

* * *

>d
Nickolodeon game
You can play the Spongebob game to the north, Alvin and the chipmunks to the south, Henry Danger to the west, and Teenage Mutant Ninja Turtles to the east. Go up twice to leave.

>s
Chipmunk house
You can see the exit to the south or you can leave the game by going north.

>n
You can't go that way.

>l
Nickolodeon Game Menu
You can play the Spongebob game to the north, Alvin and the chipmunks to the south, Henry Danger to the west, and Teenage Mutant Ninja Turtles to the east. Go up twice to leave.

* * *

>s
Chipmunk house
You can see the exit to the south or you can leave the game by going north.

>s
Neighborhood
You can see your house to the north, and The Tree house to the south.

You can see evil robot here.

>x evil robot
You see nothing special about evil robot.

* * *

>d
Nickolodeon game
You can play the Spongebob game to the north, Alvin and the chipmunks to the south, Henry Danger to the west, and Teenage Mutant Ninja Turtles to the east. Go up twice to leave.

>d
You can't go that way.

* * *

>s
living room
You are in the living room. You see Lynn to the north, Lola and Lana to the south, stairs to the west, and the exit to the east.

>s
South Living room
You see Living room to the north and the basement stairs to the south.

You can see Lola and Lana here.

>d
Secret Passageway
So, I guess you found my secret room. Either you beat the game, or you found a hack to it. If the first one, good job! Well, you know where to go from here.

* * *

>d
Lower Room
Now you are in the Lower Room.  The only way out is back up.

You can see Lionel here.

* * *

>l
Lower Room
Now you are in the Lower Room.  The only way out is back up.

You can see Lionel here.

>n
You can't go that way.

>u
South Room
Now you are in the South Room.  You can go back north, or down.

You can see a quarter here.

* * *

>d
Nickolodeon game
You can play the Spongebob game to the north, Alvin and the chipmunks to the south, Henry Danger to the west, and Teenage Mutant Ninja Turtles to the east. Go up twice to leave.

>n
Pineapple house
You can see Gary here.

>n
Bikini Bottom

* * *

>s
South Living room
You see Living room to the north and the basement stairs to the south.

You can see Lola and Lana here.

>s
Basement
You see Lola and Lana to the north.

You can see Couch 2 and a Video game console here.

>d
Secret Passageway
So, I guess you found my secret room. Either you beat the game, or you found a hack to it. If the first one, good job! Well, you know where to go from here.

>d
Nickolodeon game
You can play the Spongebob game to the north, Alvin and the chipmunks to the south, Henry Danger to the west, and Teenage Mutant Ninja Turtles to the east. Go up twice to leave.

You can see Game Gate here.

>s
Chipmunk house
You can see the exit to the south or you can leave the game by going north.

You can see Dave here.

>s
Neighborhood
You can see your house to the north, and The Tree house to the south.

You can see evil robot here.

>s
Tree house
You are in The Tree house. You can leave to the north.

You can see Dave's computer here.

>take all
(Dave's computer)
Taken.

>n
Neighborhood
You can see your house to the north, and The Tree house to the south.

You can see evil robot here.

>squirt robot
You can only squirt if you have a squirt gun, squirt.

>n
Chipmunk house
You can see the exit to the south or you can leave the game by going north.

You can see Dave here.

>give computer to dave
Dave is excited and gives you a squirt gun as a reward. Maybe you could use this to fight the evil robot.

>s
Neighborhood
You can see your house to the north, and The Tree house to the south.

You can see evil robot here.

>squirt robot
You are now squirting the evil robot. You save the neighborhood and get a gamer pass!

>i
You are carrying:
  a squirt gun
  gamer pass 2

* * *

>s
living room
You are in the living room. You see Lynn to the north, Lola and Lana to the south, stairs to the west, and the exit to the east.

>drop quarter 1
Dropped.

>drop quarter 2
Dropped.

>l
Basement
You see Lola and Lana to the north.

You can see Quarter 2, Quarter 1, Couch 2 and a Video game concle here.

>n
South Living room
You see Living room to the north and the basement stairs to the south.

You can see Lola and Lana here.

>give quarters to lola
Which do you mean, Quarter 4 or Quarter 3?

>i
You are carrying:
  Quarter 4
  Quarter 3

>s
Basement
You see Lola and Lana to the north.

You can see Quarter 2, Quarter 1, Couch 2 and a Video game concle here.

>get all
Quarter 2: Taken.
Quarter 1: Taken.
Couch 2: Taken.
Video game concle: Taken.

>n
South Living room
You see Living room to the north and the basement stairs to the south.

You can see Lola and Lana here.

>give quarters to lola
Which do you mean, Quarter 1, Quarter 2, Quarter 4 or Quarter 3?

* * *

>s
living room
You are in the living room. You see Lynn to the north, Lola and Lana to the south, stairs to the west, and the exit to the east.

>drop all quarters
Dropped.

>n
South Living room
You see Living room to the north and the basement stairs to the south.

You can see Lola and Lana here.

>give quarter to lola'
Which do you mean, Quarter 4, Quarter 2 or Quarter 3?

>i
You are carrying:
  Quarter 4
  Quarter 2
  Quarter 3

>s
Basement
You see Lola and Lana to the north.

You can see Quarter 1, Couch 2 and a Video game concle here.

>drop all
Quarter 4: Dropped.
Quarter 2: Dropped.
Quarter 3: Dropped.

>n
South Living room
You see Living room to the north and the basement stairs to the south.

You can see Lola and Lana here.

>give quater to lola
You can't see any such thing.

>s
Basement
You see Lola and Lana to the north.

You can see Quarter 3, Quarter 2, Quarter 4, Quarter 1, Couch 2 and a Video game concle here.

>give quarater
You can't see any such thing.

>take quater 1
You can't see any such thing.

>take quarter 1
Taken.

>n
South Living room
You see Living room to the north and the basement stairs to the south.

You can see Lola and Lana here.

>give quarter to lola
Not enough something something.

>i
You are carrying:
  Quarter 1

>i
You are carrying:
  Quarter 1

* * *

>s
living room
You are in the living room. You see Lynn to the north, Lola and Lana to the south, stairs to the west, and the exit to the east.

>e
Royal Woods Main Street
You can see a video game shop to the north, your house to the west, and the schools to the south.

>u
You can't go that way.

>s
Royal Woods School Grounds
These bullies come to stop you from entering unless you give them money. You see the inside of the school to the south, and Royal Woods Main Street to the north.

You can see Bully and Locked safe 3 (closed) here.

>u
football stadium
The Football game is about to start, and guess who your playing against- Lynn! She says "Wow, Lincoln! I didn't know that you were coming to the same football game as me!"

You can see a ball and a Scoring post here.

>throw ball at post
(first taking the ball)
You throw the ball into the scoring post, and you won the game! The same bully from earlier hands you $500. You decide to split it evenly between your ten sisters- that means $45 each- exactly enough!

The Scoring post doesn't seem interested.

* * *

>u
football stadium
The Football game is about to start, and guess who your playing against- Lynn! She says "Wow, Lincoln! I didn't know that you were coming to the same football game as me!"

You can see a ball and a Scoring post here.

>throw ball at post
(first taking the ball)
You throw the ball into the scoring post, and you won the game! The same bully from earlier hands you $500. You decide to split it evenly between your ten sisters- that means $45 each- exactly enough!

* * *

>e
Royal Woods Main Street
You can see a video game shop to the north, your house to the west, and the schools to the south.

>w
living room
You are in the living room. You see Lynn to the north, Lola and Lana to the south, stairs to the west, and the exit to the east.

>s
South Living room
You see Living room to the north and the basement stairs to the south.

You can see Lola and Lana here.

* * *

>d
Nickolodeon game
You can play the Spongebob game to the north, Alvin and the chipmunks to the south, Henry Danger to the west, and Teenage Mutant Ninja Turtles to the east. Go up twice to leave.

You can see Game Gate here.

>n
Pineapple house
You can go north.

You can see Gary here.

* * *

>n
Krusty Krab
You see Bikini Bottom to the south.

You can see mister Krabs, Locked safe 5 (closed) and Krabby Patty dresser (in which is Dollar Bill 2) here.

>give bill to mister krabs
(first taking Dollar Bill 2)
mister Krabs's eyes show dollar signs and he hands you a Krabby Patty.

>s
Bikini Bottom
you  see your Pineapple house to the south and the Krusty Krab to the north.

You can see Plankton's robot here.

>throw patty at robot
you throw the Krabby Patty at the robot, and you've saved Bikini Bottom! You now have a gamer pass!

>s
Pineapple house
You can go north.

You can see Gary here.

>s
Nickolodeon game
You can play the Spongebob game to the north, Alvin and the chipmunks to the south, Henry Danger to the west, and Teenage Mutant Ninja Turtles to the east. Go up twice to leave.

You can see Game Gate here.

>s
Chipmunk house
You can see the exit to the south or you can leave the game by going north.

You can see Dave here.

* * *

>s
Tree house
You are in The Tree house. You can leave to the north.

You can see Dave's computer here.

>take all
Dave's computer: Taken.

>n
Neighborhood
You can see your house to the north, and The Tree house to the south.

You can see evil robot here.

>i
You are carrying:
  Dave's computer
  gamer pass 1

>n
Chipmunk house
You can see the exit to the south or you can leave the game by going north.

You can see Dave here.

* * *

>squirt robot
You are now squirting the evil robot. You save the neighborhood and get a gamer pass!

>n
Chipmunk house
You can see the exit to the south or you can leave the game by going north.

You can see Dave here.

>n
Nickolodeon game
You can play the Spongebob game to the north, Alvin and the chipmunks to the south, Henry Danger to the west, and Teenage Mutant Ninja Turtles to the east. Go up twice to leave.

You can see Game Gate here.

>w
Man-cave
You can leave the Man-cave by going up.

You can see a space key here.

>take all
space key: Taken.

>u
Swellview
Oh no! There's now an alien invasion from Mars! Go down to enter the Man-Cave, or go west to enter the rocket and get to Mars.

You can see a rocket and Marty here.

>unlock rocket
What do you want to unlock the rocket with?

>key
You unlock the rocket.

>w
(first opening the rocket)

Mars
You are now on Mars. You can go west to the Canyon or east to get back to earth.

You can see a rocket and a Translater here.

>take all
Translater: Taken.

>w
canyon
You are now on the canyon. You can see Mars to the east.

You can see a rover here.

>give translater to rover
The rover can now say stuff in english. it says "Oh, Wow! I can speak human language! Hey, I need you to give me this special alien bug in the valley to the west so my human controllers can finally stop searching and take me off this planet once and for all!"

>w
Valley
You are in the Valley. You see the Canyon to the east.

You can see an Alien Bug here.

>take all
Alien Bug: Taken.

>e
canyon
You are now on the canyon. You can see Mars to the east.

You can see a rover here.

>give bug to rover
You give the Alien Bug to the rover and it says "Oooh! Now I can report it to NASA!" He hands you an Omega Grenade.

>s
You can't go that way.

>e
Mars
You are now on Mars. You can go west to the Canyon or east to get back to earth.

You can see a rocket here.

>e
Swellview
Oh no! There's now an alien invasion from Mars! Go down to enter the Man-Cave, or go west to enter the rocket and get to Mars.

You can see a rocket and Marty here.

>throw grenade at marty
You did it! You blew up the alien invaders and saved swellview! You also earned a gamer pass!

>s
You can't go that way.

* * *

>e
You can't go that way.

>d
Man-cave
You can leave the Man-cave by going up.

>e
Nickolodeon game
You can play the Spongebob game to the north, Alvin and the chipmunks to the south, Henry Danger to the west, and Teenage Mutant Ninja Turtles to the east. Go up twice to leave.

You can see Game Gate here.

>e
Sewer
You are in the sewer. You see the City above you.

You can see Locked safe 6 (closed), Leo's sword and Mike's nun-chucks here.

>take all
Locked safe 6: Taken.
Leo's sword: Taken.
Mike's nun-chucks: Taken.

>n
You can't go that way.

>e
You can't go that way.

>u
City
You are in the city. You see a sai target to the east and your sewer under you.

You can see a Guard here.

>throw nun-chucks at guard
You knock him out and win your sai back.

>e
Target gate
You are in the City. You see Shredder's Castle to the east.

You can see Castle Gate and a sai target here.

>throw sai at target
(Raph's sai at the sai target)
You throw the sai and hit the target, scoring the key to the gate!

>drop key
Which do you mean, the Skull Key or the space key?

>2
Skull Key: Dropped.
space key: Dropped.

>undo
Target gate
[Previous turn undone.]

>unlock gate
What do you want to unlock Castle Gate with?

>key
Which do you mean, the Skull Key or the space key?

>1
(the Skull Key)
You unlock Castle Gate.

>e
(first opening Castle Gate)

Shredder's Castle
You are in Shredder's Castle! You see Target gate to the west.

You can see Castle Gate and Shredder here.

>throw sword at shredder
You throw the sword, and it cuts through Shredder's armor, killing him. You saved the city, and earned a gamer pass!

>w
Target gate
You are in the City. You see Shredder's Castle to the east.

You can see Castle Gate and a sai target here.

>w
City
You are in the city. You see a sai target to the east and your sewer under you.

You can see a Guard here.

>w
You can't go that way.

>d
Sewer
You are in the sewer. You see the City above you.

>w
Nickolodeon game
You can play the Spongebob game to the north, Alvin and the chipmunks to the south, Henry Danger to the west, and Teenage Mutant Ninja Turtles to the east. Go up twice to leave.

You can see Game Gate here.

>u
Secret Passageway
So, I guess you found my secret room. Either you beat the game, or you found a hack to it. If the first one, good job! Well, you know where to go from here.

>u
Basement
You see Lola and Lana to the north.

You can see Couch 2 and a Video game console here.

>n
South Living room
You see Living room to the north and the basement stairs to the south.

You can see Lola and Lana here.

>e
You can't go that way.

>n
living room
You are in the living room. You see Lynn to the north, Lola and Lana to the south, stairs to the west, and the exit to the east.

>e
Royal Woods Main Street
You can see a video game shop to the north, your house to the west, and the schools to the south.

* * *

>n
video game shop
You are in the video game shop. Here you can buy that video game + collectable rare cards for just $45!

You can see an owner and Locked safe 4 (closed) here.

>give gamer passes to owner
"Come on, man. earn more game passes if you want to play the secret level."

>i
You are carrying:
  gamer pass 4
  a Skull Key
  Locked safe 6 (closed and locked)
  gamer pass 3
  a space key
  a squirt gun
  gamer pass 1

* * *

Lynn's area
You entered the area where Lynn excercises. You see the Living room to the south, and a couch to the north.

You can see Lynn and Lynn's hair here.

Loud House 'game on'
An Interactive Fiction by Caleb Wilson
Release 1 / Serial number 210525 / Inform 7 build 6M62 (I6/v6.33 lib 6/12N) SD

Lynn's area
You entered the area where Lynn excercises. You see the Living room to the south, and a couch to the north.

You can see Lynn and Lynn's hair here.

>n
North Living room
You can see Lynn to the south.

You can see Couch 1 (in which is Quarter 4) here.

>w
Lynn's and Lucy's room
Now you are in Lynn's and Lucy's room. Only Lucy is inside. The only way out is back east.

You can see a coffin (in which is Quarter 1) here.

>e
hallway
Now you are in the hallway.  You can go back south, or west to Lynn's and Lucy's room or east to Lisa's and Lily's room or north for northern hallway.

>n
north hall
You are in north hall. you see Lori's and Leni's room to the east, Luan's and Luna's room to the west, hallway to the south, and far north hall to the north.

>e
Lori's and Leni's room
you see Leni's bed, Lori's bed, and a dresser. You see north hall to the west.

You can see Leni's bed here.

>x Leni's bed
You check Leni's bed, but all you see are clothes and dolls.

* * *

>e
hallway
Now you are in the hallway.  You can go back south, or west to Lynn's and Lucy's room or east to Lisa's and Lily's room or north for northern hallway.

>e
Lisa's and Lily's room
Now you are in Lisa's and Lily's room. You see Lisa working on a device and Lily in her crib.

Lisa's line here.

* * *

>w
Lynn's and Lucy's room
Now you are in Lynn's and Lucy's room. Only Lucy is inside. The only way out is back east.

You can see a coffin (in which is Quarter 1) here.

>x coffin
Dank.  Dark. And full of bats.

In the coffin is Quarter 1.

>e
hallway
Now you are in the hallway.  You can go back south, or west to Lynn's and Lucy's room or east to Lisa's and Lily's room or north for northern hallway.

>s
Your Room
This is the description of the your room.  You can go north.

* * *

>e
Lisa's and Lily's room
Now you are in Lisa's and Lily's room. You see Lisa working on a device and Lily in her crib.

Lisa's line here.

>talk to lisa
"I am working on a device to turn a regular kid into an athlete! It requires DNA from someone who's good at sports, though." Now where can you find an athlete kid that's good at sports?

>w
hallway
Now you are in the hallway.  You can go back south, or west to Lynn's and Lucy's room or east to Lisa's and Lily's room or north for northern hallway.

>s
Your Room
You need money to buy a video game.  You can go north to the hallway.

* * *

>x coffin
Dank.  Dark. And full of bats.

In the coffin is Quarter 1.

>i
You are carrying nothing.

* * *

>x coffin
Dank.  Dark. And full of bats.

In the coffin is Quarter 1.

>take Quarter 1
Taken.

>e
hallway
Now you are in the hallway.  You can go back south, or west to Lynn's and Lucy's room or east to Lisa's and Lily's room or north for northern hallway.

* * *

>n
north hall
You are in north hall. you see Lori's and Leni's room to the east, Luan's and Luna's room to the west, hallway to the south, and far north hall to the north.

>e
Lori's and Leni's room
you see Leni's bed, Lori's bed, and a dresser. You see north hall to the west.

All you see are Leni's bed, Lori's bed and a dresser.

>x dresser
In the dresser is Quarter 2.

>take Quarter 2
Taken.

>w
north hall
You are in north hall. you see Lori's and Leni's room to the east, Luan's and Luna's room to the west, hallway to the south, and far north hall to the north.

* * *

>e
hallway
Now you are in the hallway.  You can go back south, or west to Lynn's and Lucy's room or east to Lisa's and Lily's room or north for northern hallway.

>e
Lisa's and Lily's room
Now you are in Lisa's and Lily's room. You see Lisa working on a device and Lily in her crib.

You can see Lisa and Locked safe (closed) here.

>w
hallway
Now you are in the hallway.  You can go back south, or west to Lynn's and Lucy's room or east to Lisa's and Lily's room or north for northern hallway.

* * *

>w
Lynn's and Lucy's room
Now you are in Lynn's and Lucy's room. Only Lucy is inside. The only way out is back east.

You can see a coffin (in which is Quarter 1) here.

>w
Lola's and Lana's room
You enter Lola's and Lana's room. You see far north hall to the east.

You can see a mirror, a teacup, a frog cage and Locked safe 2 (closed) here.

* * *

>n
North Living room
You can see Lynn to the south.

You can see Couch 1 (in which is Quarter 4) here.

>e
Lisa's and Lily's room
Now you are in Lisa's and Lily's room. You see the north hall to the west.

You can see Lisa and a locked safe (closed) here.

>w
hallway
Now you are in the hallway.  You can go back south, or west to Lynn's and Lucy's room, or east to Lisa's and Lily's room or north to northern hallway.

>w
Lynn's and Lucy's room
Now you are in Lynn's and Lucy's room. Only Lucy is inside. The only way out is back east.

You can see a coffin (in which is Quarter 1) and Lucy here.

* * *

>e
Lisa's and Lily's room
Now you are in Lisa's and Lily's room. You see the north hall to the west.

You can see Lisa and a locked safe (closed) here.

>x lisa
Lisa's description here.

>talk to lisa
That's not a verb I recognise.

>talk to lisa
That's not a verb I recognise.

>ask lisa about quarter
There is no reply.

* * *

>e
Lisa's and Lily's room
Now you are in Lisa's and Lily's room. You see the north hall to the west.

You can see Lisa and a locked safe (closed) here.

>ask lisa about quarter
(To communicate in Loud House 'game on', TALK TO a character.)

* * *

>e
Lisa's and Lily's room
Now you are in Lisa's and Lily's room. You see the north hall to the west.

You can see Lisa and a locked safe (closed) here.

>talk to lisa
Lisa shushes you.  "I am busy working on my device!"

* * *

>e
Lisa's and Lily's room
Now you are in Lisa's and Lily's room. You see the north hall to the west.

You can see Lisa and a locked safe (closed) here.

>talk to Lisa
"I am working on a device to turn a regular kid into an athlete! It requires DNA from someone who's good at sports, though." Now where can you find an athlete kid that's good at sports?

>w
hallway
Now you are in the hallway.  You can go back south, or west to Lynn's and Lucy's room or east to Lisa's and Lily's room or north for northern hallway.

>w
Lynn's and Lucy's room
Now you are in Lynn's and Lucy's room. Only Lucy is inside. You see a coffin. The only way out is back east.

You can see a coffin here.

>x coffin
Dank.  Dark. full of bats. There is a quarter that you can take out

>e
hallway
Now you are in the hallway.  You can go back south, or west to Lynn's and Lucy's room or east to Lisa's and Lily's room or north for northern hallway.

* * *

>e
Lori's and Leni's room
you see Leni's bed, Lori's bed, and a dresser. You see north hall to the west.

All you see are Leni's bed, Lori's bed and a dresser.

>i
You are carrying nothing.

>x dresser
In the dresser is Quarter 2.

* * *

>take Quarter 2
Taken.

>i
You are carrying:
  Quarter 2

>iw
That's not a verb I recognise.

>w
north hall
You are in north hall. you see Lori's and Leni's room to the east, Luan's and Luna's room to the west, hallway to the south, and far north hall to the north.

>w
Luan's and Luna's room
You are in Luan's and Luna's room. You see north hall to the east.

* * *

>e
Lisa's and Lily's room
Now you are in Lisa's and Lily's room. You see the north hall to the west.

You can see Lisa and a locked safe (closed) here.

>i
You are carrying nothing.

>give me to lisa
(first taking yourself)
You are always self-possessed.

>w
hallway
Now you are in the hallway.  You can go back south, or west to Lynn's and Lucy's room or east to Lisa's and Lily's room or north for northern hallway.

* * *

>n
north hall
You are in north hall. you see Lori's and Leni's room to the east, Luan's and Luna's room to the west, hallway to the south, and far north hall to the north.

>s
hallway
Now you are in the hallway.  You can go back south, or west to Lynn's and Lucy's room or east to Lisa's and Lily's room or north for northern hallway.

* * *

>w
hallway
Now you are in the hallway.  You can go back south, or west to Lynn's and Lucy's room or east to Lisa's and Lily's room or north for northern hallway.

>w
Lynn's and Lucy's room
Now you are in Lynn's and Lucy's room. Only Lucy is inside. The only way out is back east.

You can see a coffin (in which is Quarter 1) here.

* * *

>x coffin
Dank.  Dark. And full of bats.

In the coffin is Quarter 1.

>get quarter 1
Taken.

>e
hallway
Now you are in the hallway.  You can go back south, or west to Lynn's and Lucy's room or east to Lisa's and Lily's room or north for northern hallway.

* * *

>e
Lisa's and Lily's room
Now you are in Lisa's and Lily's room. You see Lisa working on a device and Lily in her crib.

You can see Lisa here.

>give quarter to lisa
Xyz
Lisa doesn't seem interested.

* * *

>e
Lisa's and Lily's room
Now you are in Lisa's and Lily's room. You see the north hall to the west.

You can see Lisa and a locked safe (closed) here.

>s
Royal Woods School Grounds
These bullies come to stop you from entering unless you give them money. You see the inside of the school to the south, and Royal Woods Main Street to the north.

You can see Bully and Locked safe 3 (closed) here.

>n
Royal Woods Main Street
You can see a video game shop to the north, your house to the west, and the schools to the south.

>w
Living room
You are in the Living room. You see Lynn to the north, Lola and Lana to the south, stairs to the west, and the exit to the east.

>give Quarters to Lola
You can't see any such thing.

>s
South Living room
You see Living room to the north and the basement stairs to the south.

You can see Lola and Lana here.

>Give Quarters to Lola
Lola is excited and hands you a dollar bill.

>n
Living room
You are in the Living room. You see Lynn to the north, Lola and Lana to the south, stairs to the west, and the exit to the east.

* * *

>s
Royal Woods School Grounds
These bullies come to stop you from entering unless you give them money. You see the inside of the school to the south, and Royal Woods Main Street to the north.

You can see Bully here.

>give Dollar Bill to Bully
"Come on in," said the Bully. "Oh, and, the football stadium is above here."

You aren't holding the Dollar Bill.

>u
Football Stadium

* * *

>u
Football Stadium
The Football game is about to start, and guess who your playing against- Lynn! She says "Wow, Lincoln! I didn't know that you were coming to the same football game as me!"

You can see a ball and a Scoring post here.

>take ball
Taken.

>pass it to Lynn 2
That's not a verb I recognise.

>pass ball to Lynn 2
That's not a verb I recognise.

>give ball to Lynn 2
Lynn 2 doesn't seem interested.

* * *

>u
Football Stadium
The Football game is about to start, and guess who your playing against- Lynn! She says "Wow, Lincoln! I didn't know that you were coming to the same football game as me!"

You can see a ball and a Scoring post here.

>give ball to scoring post
(first taking the ball)
The Scoring post doesn't seem interested.

>throw ball at scoring post
You lack the nerve when it comes to the crucial moment.

* * *

>u
Football Stadium
The Football game is about to start, and guess who your playing against- Lynn! She says "Wow, Lincoln! I didn't know that you were coming to the same football game as me!"

You can see a ball and a Scoring post here.

>throw ball at scoring post
(first taking the ball)
You throw the ball into the scoring post, and you won the game! The same bully from earlier hands you $500. You decide to split it evenly between your ten sisters- that means $45 each- exactly enough!

You aren't holding the ball.

>d
Royal Woods School Grounds
These bullies come to stop you from entering unless you give them money. You see the inside of the school to the south, and Royal Woods Main Street to the north.

You can see Bully and Locked safe 3 (closed) here.

* * *

>n
video game shop
You are in the video game shop. Here you can buy that video game + collectable rare cards for just $45!

You can see an owner and Locked safe 4 (closed) here.

>give $45.45 to owner
You can't see any such thing.

>give $45.45 to the owner
You can't see any such thing.

>i
You are carrying:
  $45.45
  Quarter 4
  Quarter 2
  Quarter 3
  Quarter 1

>give owner $45.45
You can't see any such thing.

>drop $45.45
You can't see any such thing.

>i
You are carrying:
  $45.45
  Quarter 4
  Quarter 2
  Quarter 3
  Quarter 1

>give 45 dollars to owner
You can't use multiple objects with that verb.

>give $45.45 to owner
You can't see any such thing.

>throw ball at scoring post
You can't see any such thing.

>s
Royal Woods Main Street
You can see a video game shop to the north, your house to the west, and the schools to the south.

* * *

>s
Royal Woods School Grounds
These bullies come to stop you from entering unless you give them money. You see the inside of the school to the south, and Royal Woods Main Street to the north.

You can see Bully and Locked safe 3 (closed) here.

>u
Football Stadium
The Football game is about to start, and guess who your playing against- Lynn! She says "Wow, Lincoln! I didn't know that you were coming to the same football game as me!"

You can see a Scoring post here.

>i
You are carrying:
  $45.45
  Quarter 4
  Quarter 2
  Quarter 3
  Quarter 1

>drop $45.45
You can't see any such thing.

>drop 45.45
You can't see any such thing.

* * *

>give $45 to owner
"Thank you for buying from Royal Woods Video Game shop," said the owner. "oh, and don't forget that you can play your video game in the room under the room under the basement."

You aren't holding $45.

>i
You are carrying:
  collectable cards
  Quarter 4
  Quarter 2
  Quarter 3
  Quarter 1

>s
Royal Woods Main Street
You can see a video game shop to the north, your house to the west, and the schools to the south.

* * *

>u
Football Stadium
The Football game is about to start, and guess who your playing against- Lynn! She says "Wow, Lincoln! I didn't know that you were coming to the same football game as me!"

You can see a ball and a Scoring post here.

>d
Royal Woods School Grounds
These bullies come to stop you from entering unless you give them money. You see the inside of the school to the south, and Royal Woods Main Street to the north.

You can see Bully and Locked safe 3 (closed) here.

* * *

>e
Lisa's and Lily's room
Now you are in Lisa's and Lily's room. You see the north hall to the west.

You can see Lisa and a locked safe (closed) here.

>n
video game shop
You are in the video game shop. Here you can buy that video game + collectable rare cards for just 45.45!

You can see an owner and Locked safe 4 (closed) here.

>x owner
You see nothing special about the owner.

* * *

>Hi
That's not a verb I recognise.

* * *

>s
Royal Woods Main Street
You can see a video game shop to the north, your house to the west, and the schools to the south.

* * *

>s
Royal Woods School Grounds
These bullies come to stop you from entering unless you give them money. You see the inside of the school to the south, and Royal Woods Main Street to the north.

You can see Bully and Locked safe 3 (closed) here.

>i
You are carrying:
  Quarter 4
  Quarter 2
  Quarter 3
  Quarter 1

>u
Football Stadium
The Football game is about to start, and guess who your playing against- Lynn! She says "Wow, Lincoln! I didn't know that you were coming to the same football game as me!"

You can see a ball and a Scoring post here.

>throw ball at scoring post
(first taking the ball)
You throw the ball into the scoring post, and you won the game! The same bully from earlier hands you $500. You decide to split it evenly between your ten sisters- that means 45.45 each- exactly enough!

You aren't holding the ball.

>i
You are carrying:
  $45.45
  Quarter 4
  Quarter 2
  Quarter 3
  Quarter 1

>d
Royal Woods School Grounds
These bullies come to stop you from entering unless you give them money. You see the inside of the school to the south, and Royal Woods Main Street to the north.

You can see Bully and Locked safe 3 (closed) here.

>i
You are carrying:
  $45.45
  Quarter 4
  Quarter 2
  Quarter 3
  Quarter 1

>n
Royal Woods Main Street
You can see a video game shop to the north, your house to the west, and the schools to the south.

>n
video game shop
You are in the video game shop. Here you can buy that video game + collectable rare cards for just 45.45!

You can see an owner here.

>give $45.45 to owner
You can't see any such thing.

* * *

>i
You are carrying:
  $45.45
  Quarter 4
  Quarter 2
  Quarter 3
  Quarter 1

>give $45.45 to the owner
You can't see any such thing.

>give $45.45 to owner
You can't see any such thing.

* * *

>n
video game shop
You are in the video game shop. Here you can buy that video game + collectable rare cards for just 45.45!

You can see an owner and Locked safe 4 (closed) here.

>take collectible cards
Taken.

* * *

>n
North Living room
You can see Lynn to the south.

You can see Couch 1 (in which is Quarter 4) here.

>n
north hall
You are in the north hall. you see Lori's and Leni's room to the east, Luan's and Luna's room to the west, hallway to the south, and far north hall to the north.

>w
Luan's and Luna's room
You are in Luan's and Luna's room. You see the north hall to the east.

You can see Luan, Luna, a puppet and a speaker here.

>x coffin
You can't see any such thing.

* * *

>w
Luan's and Luna's room
You are in Luan's and Luna's room. You see the north hall to the east.

You can see Luan, Luna, a puppet and a speaker here.

>talk to Luan
You try to ask Luan for advice on how to make money, but she inturupts with a joke. "why did the chicken cross the road? To prove it wasn't a chicken!" She laughs at her own joke.

>x Luan
She is wearing a dress with a  yellow bottom to it and a squirt flower at the top of the dress.

>e
north hall
You are in north hall. you see Lori's and Leni's room to the east, Luan's and Luna's room to the west, hallway to the south, and far north hall to the north.

>e
Lori's and Leni's room
you see Leni's bed, Lori's bed, and a dresser. You see north hall to the west.

All you see are Leni's bed, Lori's bed and a dresser.

>w
north hall
You are in north hall. you see Lori's and Leni's room to the east, Luan's and Luna's room to the west, hallway to the south, and far north hall to the north.

>w
Luan's and Luna's room
You are in Luan's and Luna's room. You see north hall to the east.

You can see Luan here.

>e
north hall
You are in north hall. you see Lori's and Leni's room to the east, Luan's and Luna's room to the west, hallway to the south, and far north hall to the north.

* * *

>w
north hall
You are in north hall. you see Lori's and Leni's room to the east, Luan's and Luna's room to the west, hallway to the south, and far north hall to the north.

I beg your pardon?

>w
Luan's and Luna's room
You are in Luan's and Luna's room. You see north hall to the east.

You can see Luan here.

* * *

>e
north hall
You are in north hall. you see Lori's and Leni's room to the east, Luan's and Luna's room to the west, hallway to the south, and far north hall to the north.

>w
Luan's and Luna's room
You are in Luan's and Luna's room. You see north hall to the east.

You can see Luan here.

>w
You can't go that way.

>e
north hall
You are in north hall. you see Lori's and Leni's room to the east, Luan's and Luna's room to the west, hallway to the south, and far north hall to the north.

* * *

>w
Luan's and Luna's room
You are in Luan's and Luna's room. You see the north hall to the east.

You can see Luan, Luna, a puppet and a speaker here.

>x speaker
You check every inch of the speaker, but no loose change found.

* * *

>w
Luan's and Luna's room
You are in Luan's and Luna's room. You see the north hall to the east.

You can see Luan, Luna, a puppet and a speaker here.

>e
north hall
You are in the north hall. you see Lori's and Leni's room to the east, Luan's and Luna's room to the west, hallway to the south, and far north hall to the north.

>e
Lori's and Leni's room
 You see north hall to the west.

All you see are Leni's bed, Lori's bed and a dresser.

>w
north hall
You are in the north hall. you see Lori's and Leni's room to the east, Luan's and Luna's room to the west, hallway to the south, and far north hall to the north.

>s
hallway
Now you are in the hallway.  You can go back south, or west to Lynn's and Lucy's room, or east to Lisa's and Lily's room or north to the north hall.

>w
Lynn's and Lucy's room
Now you are in Lynn's and Lucy's room. Only Lucy is inside. The only way out is back east.

You can see a coffin (in which is Quarter 1) and Lucy here.

>talk to lucy
Lucy remains silent.

* * *

>n
north hall
You are in the north hall. you see Lori's and Leni's room to the east, Luan's and Luna's room to the west, hallway to the south, and far north hall to the north.

>l
north hall

>s
hallway
Now you are in the hallway.  You can go back south, or west to Lynn's and Lucy's room or east to Lisa's and Lily's room or north for northern hallway.

>e
Lisa's and Lily's room
Now you are in Lisa's and Lily's room. You see Lisa working on a device and Lily in her crib.

Lisa's line here.

* * *

>x coffin
Dank.  Dark. full of bats. There is a quarter that you can take out

>get quarter
You can't see any such thing.

>i
You are carrying nothing.

>e
hallway
Now you are in the hallway.  You can go back south, or west to Lynn's and Lucy's room or east to Lisa's and Lily's room or north for northern hallway.

>n
north hall

* * *

>n
north hall
You are in the north hall. you see Lori's and Leni's room to the east, Luan's and Luna's room to the west, hallway to the south, and far north hall to the north.

>e
Lori's and Leni's room
 You see north hall to the west.

All you see are Leni's bed, Lori's bed and a dresser.

* * *

>w
north hall
You are in the north hall. you see Lori's and Leni's room to the east, Luan's and Luna's room to the west, hallway to the south, and far north hall to the north.

>s
hallway
Now you are in the hallway.  You can go back south, or west to Lynn's and Lucy's room or east to Lisa's and Lily's room or north for northern hallway.

* * *

>s
Your Room
You need money to buy a video game.  You can go north to the hallway.

>n
hallway
Now you are in the hallway.  You can go back south, or west to Lynn's and Lucy's room or east to Lisa's and Lily's room or north for northern hallway.

* * *

>s
hallway
Now you are in the hallway.  You can go back south, or west to Lynn's and Lucy's room or east to Lisa's and Lily's room or north for northern hallway.

>w
Lynn's and Lucy's room
Now you are in Lynn's and Lucy's room. Only Lucy is inside. You see a coffin. The only way out is back east.

You can see a coffin here.

* * *

>w
north hall
You are in the north hall. you see Lori's and Leni's room to the east, Luan's and Luna's room to the west, hallway to the south, and far north hall to the north.

>w
You can't go that way.

>s
hallway
Now you are in the hallway.  You can go back south, or west to Lynn's and Lucy's room or east to Lisa's and Lily's room or north for northern hallway.

* * *

>w
north hall
You are in the north hall. you see Lori's and Leni's room to the east, Luan's and Luna's room to the west, hallway to the south, and far north hall to the north.

>n
far north hall
You are in far north hall. You see Lola's and Lana's room to the west, stairs to the east, and north hall to the south.

>e
living room
You are in the living room. You see Lynn to the north, Lola and Lana to the south, stairs to the west, and the exit to the east.

>s
South Living room
You see Living room to the north and the basement stairs to the south.

You can see Lola and Lana here.

* * *

>n
Krusty Krab
You see Bikini Bottom to the south.

You can see mister Krabs, Locked safe 5 (closed) and Krabby Patty dresser (in which is Dollar Bill 2) here.

>give dollar bill to mister krabs
(first taking Dollar Bill 2)
mister Krabs's eyes show dollar sighns and he hands you a Krabby Patty.

You aren't holding Dollar Bill 2.

>n
You can't go that way.

>s
Bikini Bottom
you  see your Pineapple house to the south and the Krusty Krab to the north.

You can see Plankton's robot here.

>throw patty at robot
you throw the Krabby Patty at the robot, and you've saved Bikini Bottom!

You aren't holding Krabby Patty.

>s
Pineapple house
You can go north.

You can see Gary here.

* * *

>s
Tree house
You are in The Tree house. You can leave to the north.

You can see Dave's computer here.

>take computer
Taken.

>n
Neighborhood
You can see your house to the north, and The Tree house to the south.

You can see evil robot here.

>n
Chipmunk house
You can see the exit to the south or you can leave the game by going north.

You can see Dave here.

>give computer to dave
Dave is excited and gives you a squirt gun as a reward. Maybe you could use this to fight the evil robot.

You aren't holding Dave's computer.

>s
Neighborhood
You can see your house to the north, and The Tree house to the south.

You can see evil robot here.

>squirt robot
You are now squirting the evil robot.

>s
Tree house
You are in The Tree house. You can leave to the north.

>n
Neighborhood
You can see your house to the north, and The Tree house to the south.

You can see evil robot here.

* * *

>w
Man-cave
You can leave the Man-cave by going up.

You can see a space key here.

>take key
Taken.

>u
Swellview
Oh no! There's now an alien invasion from Mars! Go down to enter the Man-Cave, or go west to enter the rocket and get to Mars.

You can see a rocket and Marty here.

* * *

>w
(first opening the rocket)

Mars
You are now on Mars. You can go west to the Canyon or east to get back to earth.

You can see a rocket and a Translater here.

>w
Canyon
You are now on the Mountian. You can see Mars to the east.

You can see a rover here.

* * *

>e
Lori's and Leni's room
 You see north hall to the west.

All you see are Leni's bed, Lori's bed and a dresser.

>x Leni's bed
You see nothing special about Leni's bed.

* * *

>e
Lori's and Leni's room
 You see north hall to the west.

All you see are Leni's bed, Lori's bed and a dresser.

>x Lori's bed
You check Lori's bed, and you find Lori's phone.

On Lori's bed is Lori's phone.

>x Lori's phone
You turn on Lori's phone, and you see an advertisement for proffessional kids football. It says that only athletes 10 to 15 (of course, you're 11) can enter. it's a $1 entry fee, and if you win, you'll earn $500! You should keep that in mind. Just collect 4 Quarters and become an athlete to enter.

>w
north hall
You are in north hall. you see Lori's and Leni's room to the east, Luan's and Luna's room to the west, hallway to the south, and far north hall to the north.

* * *

>e
Lori's and Leni's room
 You see north hall to the west.

All you see are Leni's bed, Lori's bed and a dresser.

>x bed
Which do you mean, Leni's bed or Lori's bed?

>x lori's bed
You check Lori's bed, and you find Lori's phone.

On Lori's bed is Lori's phone.

>get phone
You can't see any such thing.

>get phone from lori's bed
You can't see any such thing.

>get bed
Which do you mean, Leni's bed or Lori's bed?

>get lori's bed
That's fixed in place.

>get leni's bed
Taken.

>l
Lori's and Leni's room
you see Leni's bed, Lori's bed, and a dresser. You see north hall to the west.

You can see Lori's bed here.

>drop bed
(Leni's bed)
Dropped.

>l
Lori's and Leni's room
you see Leni's bed, Lori's bed, and a dresser. You see north hall to the west.

You can see Leni's bed and Lori's bed here.

* * *

>x lori's bed
You check Lori's bed, and you find Lori's phone.

On Lori's bed is Lori's phone.

>x phone
You can't see any such thing.

>x phone on bed
You can't see any such thing.

>x lori's phone
I only understood you as far as wanting to examine Lori's bed.

* * *

>e
Lori's and Leni's room
 You see north hall to the west.

All you see are Leni's bed, Lori's bed and a dresser.

>x phone
You see nothing special about Lori's phone.

* * *

>e
Lori's and Leni's room
 You see north hall to the west.

All you see are Leni's bed, Lori's bed and a dresser.

I beg your pardon?

>x pnone
You can't see any such thing.

>x phone
You see nothing special about Lori's phone.

>x lori's bed
You check Lori's bed, and you find Lori's phone.

On Lori's bed is Lori's phone.

>l
Lori's and Leni's room
you see Leni's bed, Lori's bed, and a dresser. You see north hall to the west.

Strewn carelessly on the floor are Leni's bed and Lori's bed.

* * *

>e
Lori's and Leni's room
 You see north hall to the west.

All you see are Leni's bed, Lori's bed and a dresser.

>x lori's bed
You check Lori's bed, and you find Lori's phone.

On Lori's bed is Lori's phone.

>get phone
Taken.

>x phone
You see nothing special about Lori's phone.

>i
You are carrying:
  Lori's phone

* * *

>e
Lori's and Leni's room
 You see north hall to the west.

All you see are Leni's bed, Lori's bed and a dresser.

>x dresser
In the dresser is a Quarter.

>take Quarter
Taken.

* * *

>e
Lori's and Leni's room
 You see north hall to the west.

All you see are Leni's bed, Lori's bed and a dresser.

>open dresser
It isn't something you can open.

>x dresser
In the dresser is Quarter 2.

* * *

>w
north hall
You are in north hall. you see Lori's and Leni's room to the east, Luan's and Luna's room to the west, hallway to the south, and far north hall to the north.

>s
hallway
Now you are in the hallway.  You can go back south, or west to Lynn's and Lucy's room or east to Lisa's and Lily's room or north for northern hallway.

>w
Lynn's and Lucy's room
Now you are in Lynn's and Lucy's room. Only Lucy is inside. The only way out is back east.

You can see a coffin (in which is Quarter 1) here.

>take Quarter 1
Taken.

* * *

>n
far north hall
You are in far north hall. You see Lola's and Lana's room to the west, stairs to the east, and north hall to the south.

>e
Living room
You are in the Living room. You see Lynn to the north, Lola and Lana to the south, stairs to the west, and the exit to the east.

>n
Lynn's area
You entered the area where Lynn excercises. You see the Living room to the south, and a couch to the north.

You can see Lynn and Lynn's hair here.

>take Lynn's hair
Taken.

>n
North Living room
You can see Lynn to the south.

You can see Couch 1 (in which is Quarter 4) here.

>take quarter
(Quarter 4)
Taken.

>s
Lynn's area
You entered the area where Lynn excercises. You see the Living room to the south, and a couch to the north.

You can see Lynn here.

>s
Living room
You are in the Living room. You see Lynn to the north, Lola and Lana to the south, stairs to the west, and the exit to the east.

>w
far north hall
You are in far north hall. You see Lola's and Lana's room to the west, stairs to the east, and north hall to the south.

* * *

>s
hallway
Now you are in the hallway.  You can go back south, or west to Lynn's and Lucy's room or east to Lisa's and Lily's room or north for northern hallway.

>w
Lynn's and Lucy's room
Now you are in Lynn's and Lucy's room. Only Lucy is inside. The only way out is back east.

You can see a coffin (empty) here.

>e
hallway
Now you are in the hallway.  You can go back south, or west to Lynn's and Lucy's room or east to Lisa's and Lily's room or north for northern hallway.

* * *

>e
Lisa's and Lily's room
Now you are in Lisa's and Lily's room. You see Lisa working on a device and Lily in her crib.

You can see Lisa and Locked safe (closed) here.

>i
You are carrying:
  Quarter 4
  Lynn's hair
  Quarter 1
  Quarter 2

>give Lynn's hair to Lisa
Lisa is excited that you gave her Lynn's hair, and she blasts you with the athlete ray. She also gives you a Quarter.

>w
hallway
Now you are in the hallway.  You can go back south, or west to Lynn's and Lucy's room or east to Lisa's and Lily's room or north for northern hallway.

* * *

>n
north hall
You are in the north hall. you see Lori's and Leni's room to the east, Luan's and Luna's room to the west, hallway to the south, and far north hall to the north.

>n
far north hall
You are in far north hall. You see Lola's and Lana's room to the west, stairs to the east, and north hall to the south.

* * *

>e
Lisa's and Lily's room
Now you are in Lisa's and Lily's room. You see Lisa working on a device and Lily in her crib.

You can see Lisa here.

>x lisa
She is wearing glasses and a light green jacket.

* * *

>e
Living room
You are in the Living room. You see Lynn to the north, Lola and Lana to the south, and stairs to the west.

>n
Lynn's area
You entered the area where Lynn excercises. You see the Living room to the south.

You can see Lynn here.

>x Lynn
She is wearing her sports uniform, which her player number is 1( which stands for her being number 1 at all the sports ).

* * *

>e
Living room
You are in the Living room. You see Lynn to the north, Lola and Lana to the south, and stairs to the west.

>s
South Living room

* * *

>w
Lola's and Lana's room
You enter Lola's and Lana's room. You see far north hall to the east.

You can see a mirror, a teacup and a frog cage here.

>x mirror
You look in the mirror, and... Bingo! You see a coin in the frog cage, and a bundle of cash in the teacup!

>north
You can't go that way.

>east
far north hall
You are in far north hall. You see Lola's and Lana's room to the west, stairs to the east, and north hall to the south.

>s
north hall
You are in north hall. you see Lori's and Leni's room to the east, Luan's and Luna's room to the west, hallway to the south, and far north hall to the north.

* * *

>w
Lola's and Lana's room
You enter Lola's and Lana's room. You see far north hall to the east.

You can see a mirror, a teacup and a frog cage here.

>x teacup
You check the teacup, and you find a bundle of cash! But you can't take that. It's Lola's, and if she found out, she would do anything to make your life miserable.

* * *

>w
Lola's and Lana's room
You enter Lola's and Lana's room. You see far north hall to the east.

You can see a mirror, a teacup and a frog cage here.

>x frog cage
You look in the frog cage and find a Quarter! But Hops the frog won't let you take it. Mabey you should check a place that IS'NT a pet cage.

>x mirror
You look in the mirror, and... Bingo! You see a coin in the frog cage, and a bundle of cash in the teacup!

* * *

>w
Lola's and Lana's room
You enter Lola's and Lana's room. You see far north hall to the east.

You can see a mirror, a teacup and a frog cage here.

>n
You can't go that way.

* * *

>n
Lynn's area
You entered the area where Lynn excercises. You see the Living room to the south.

You can see Lynn here.

>talk to Lynn
She says, "I'm trying to excercise for my football game. I've been excercising for about 5 hours streight." You ask her both how she hasn't gotten tired, and why she hasn't used the bathroom for 5 hours. She answers with "1, I don't really get tired unless it's night time, and 2, it's bad luck to use the bathroom before a football game- if I go number 2, I can't be number 1."

* * *

>n
Lynn's area
You entered the area where Lynn excercises. You see the Living room to the south, and a couch to the north.

You can see Lynn and Lynn's hair here.

>talk to Lynn
She says, "I'm trying to excercise for my football game. I've been excercising for about 5 hours streight." You ask her both how she hasn't gotten tired, and why she hasn't used the bathroom for 5 hours. She answers with "1, I don't really get tired unless it's night time, and 2, it's bad luck to use the bathroom before a football game- if I go number 2, I can't be number 1." You see her excercise so hard that a bit of her hair falls off.

* * *

>take Lynn's hair
Taken.

>s
Living room
You are in the Living room. You see Lynn to the north, Lola and Lana to the south, and stairs to the west.

* * *

>s
hallway
Now you are in the hallway.  You can go back south, or west to Lynn's and Lucy's room or east to Lisa's and Lily's room or north for northern hallway.

>e
Lisa's and Lily's room
Now you are in Lisa's and Lily's room. You see Lisa working on a device and Lily in her crib.

You can see Lisa and Locked safe (in which is Quarter 3) here.

>give Lisa Lynn's hair
Lisa doesn't seem interested.

* * *

>e
Lisa's and Lily's room
Now you are in Lisa's and Lily's room. You see Lisa working on a device and Lily in her crib.

You can see Lisa and Locked safe (in which is Quarter 3) here.

>give lynn's hair to Lisa
Lisa is excited that you gave her Lynn's hair, and she blasts you with the athlete ray.

>i
You are carrying:
  Quarter 3

* * *

>s
Living room
You are in the Living room. You see Lynn to the north, Lola and Lana to the south, and stairs to the west.

>i
You are carrying:
  Lynn's hair

>w
far north hall
You are in far north hall. You see Lola's and Lana's room to the west, stairs to the east, and north hall to the south.

* * *

>e
Lisa's and Lily's room
Now you are in Lisa's and Lily's room. You see Lisa working on a device and Lily in her crib.

You can see Lisa here.

>give Lynn's hair to Lisa
Lisa is excited that you gave her Lynn's hair, and she blasts you with the athlete ray.

>w
hallway
Now you are in the hallway.  You can go back south, or west to Lynn's and Lucy's room or east to Lisa's and Lily's room or north for northern hallway.

* * *

>n
far north hall
You are in far north hall. You see Lola's and Lana's room to the west, stairs to the east, and north hall to the south.

>e
Living room
You are in the Living room. You see Lynn to the north, Lola and Lana to the south, and stairs to the west.

* * *

>n
Lynn's area
You entered the area where Lynn excercises. You see the Living room to the south, and a couch to the north.

You can see Lynn and Lynn's hair here.

>get hair
Taken.

* * *

>e
Lisa's and Lily's room
Now you are in Lisa's and Lily's room. You see Lisa working on a device and Lily in her crib.

You can see Lisa here.

>i
You are carrying:
  Lynn's hair

>give hair to lisa
Text goes here.

>i
You are carrying nothing.

>x lisa
She is wearing glasses and a light green jacket.

>i
You are carrying nothing.

* * *

>n
Lynn's area
You entered the area where Lynn excercises. You see the Living room to the south, and a couch to the north.

You can see Lynn and Lynn's hair here.

>n
North Living room
You can see Lynn to the south.

You can see Couch 1 (in which is Quarter 4) here.

>x couch 1
You examine the Couch, and...

In Couch 1 is Quarter 4.

>take Quarter 4
Taken.

>s
Lynn's area
You entered the area where Lynn excercises. You see the Living room to the south, and a couch to the north.

You can see Lynn and Lynn's hair here.

>take Lynn's hair
Taken.

* * *

>e
Lisa's and Lily's room
Now you are in Lisa's and Lily's room. You see Lisa working on a device and Lily in her crib.

You can see Lisa and Locked safe (in which is Quarter 3) here.

>give Lisa Lynn's hair
Lisa is excited that you gave her Lynn's hair, and she blasts you with the athlete ray. She also gives you a Quarter.

>i
You are carrying:
  Quarter 3
  Quarter 4

>s
You can't go that way.

>w
hallway
Now you are in the hallway.  You can go back south, or west to Lynn's and Lucy's room or east to Lisa's and Lily's room or north for northern hallway.

* * *

>w
Lynn's and Lucy's room
Now you are in Lynn's and Lucy's room. Only Lucy is inside. The only way out is back east.

You can see a coffin (in which is Quarter 1) here.

>open coffin
It isn't something you can open.

>take Quarter 1
Taken.

>i
You are carrying:
  Quarter 1
  Quarter 3
  Quarter 4

>e
hallway
Now you are in the hallway.  You can go back south, or west to Lynn's and Lucy's room or east to Lisa's and Lily's room or north for northern hallway.

* * *

>n
north hall
You are in north hall. you see Lori's and Leni's room to the east, Luan's and Luna's room to the west, hallway to the south, and far north hall to the north.

>e
Lori's and Leni's room
 You see north hall to the west.

All you see are Leni's bed, Lori's bed and a dresser.

>x dresser
In the dresser is Quarter 2.

* * *

>take Quarter 2
Taken.

>i
You are carrying:
  Quarter 2
  Quarter 1
  Quarter 3
  Quarter 4

>w
north hall
You are in north hall. you see Lori's and Leni's room to the east, Luan's and Luna's room to the west, hallway to the south, and far north hall to the north.

* * *

>s
hallway
Now you are in the hallway.  You can go back south, or west to Lynn's and Lucy's room or east to Lisa's and Lily's room or north for northern hallway.

>e
Lisa's and Lily's room
Now you are in Lisa's and Lily's room. You see Lisa working on a device and Lily in her crib.

You can see Lisa and Locked safe (empty) here.

>x locked safe
Locked safe is empty.

>w
hallway
Now you are in the hallway.  You can go back south, or west to Lynn's and Lucy's room or east to Lisa's and Lily's room or north for northern hallway.

* * *

>e
Living room
You are in the Living room. You see Lynn to the north, Lola and Lana to the south, and stairs to the west.

>n
Lynn's area
You entered the area where Lynn excercises. You see the Living room to the south, and a couch to the north.

You can see Lynn here.

>n
North Living room
You can see Lynn to the south.

You can see Couch 1 (empty) here.

>s
Lynn's area
You entered the area where Lynn excercises. You see the Living room to the south, and a couch to the north.

You can see Lynn here.

>s
Living room
You are in the Living room. You see Lynn to the north, Lola and Lana to the south, and stairs to the west.

* * *

>s
South Living room
You see Living room to the north and the basement stairs to the south.

You can see Lola, and

You can see Lana here.

>s
Basement
You see Lola and Lana to the north.

You can see Couch 2 and a Video game concle here.

>n
South Living room
You see Living room to the north and the basement stairs to the south.

You can see Lola, and

You can see Lana here.

>n
Living room
You are in the Living room. You see Lynn to the north, Lola and Lana to the south, and stairs to the west.

* * *

>e
Living room
You are in the Living room. You see Lynn to the north, Lola and Lana to the south, stairs to the west, and the exit to the east.

>s
South Living room
You see Living room to the north and the basement stairs to the south.

You can see Lola, and

You can see Lana here.

>talk to Lana
She says, "You know, I learned how to plumb, like the taste of mud, and how to repair cars through Lori's phone- maybey you should check her phone, too." She goes back to repairing Lola's go-kart.

>Hi
That's not a verb I recognise.

>n
Living room
You are in the Living room. You see Lynn to the north, Lola and Lana to the south, and stairs to the west.

>w
far north hall
You are in far north hall. You see Lola's and Lana's room to the west, stairs to the east, and north hall to the south.

* * *

>talk to Lana
She says, "You know, I learned how to plumb, like the taste of mud, and how to repair cars through Lori's phone- maybey you should check her phone, too." She goes back to repairing Lola's go-kart.

>x Lana
Lana is wearing muddy overalls (she must have been eating mud pies again) and a dirty cap.

>n
Living room
You are in the Living room. You see Lynn to the north, Lola and Lana to the south, and stairs to the west.

>n
Lynn's area
You entered the area where Lynn excercises. You see the Living room to the south.

You can see Lynn and Lynn's hair here.

>talk to Lynn
She says, "I'm trying to excercise for my football game. I've been excercising for about 5 hours streight." You ask her both how she hasn't gotten tired, and why she hasn't used the bathroom for 5 hours. She answers with "1, I don't really get tired unless it's night time, and 2, it's bad luck to use the bathroom before a football game- if I go number 2, I can't be number 1." You see her excercise so hard that a bit of her hair falls off.

* * *

>s
South Living room
You see Living room to the north and the basement stairs to the south.

You can see Lola, and

You can see Lana here.

>s
Basement
You see Lola and Lana to the north.

You can see Couch 2 here.

>u
You can't go that way.

I beg your pardon?

>u
You can't go that way.

* * *

>e
Living room
You are in the Living room. You see Lynn to the north, Lola and Lana to the south, stairs to the west, and the exit to the east.

>e
Royal Woods Main Street
You can see a video game shop to the north, your house to the west, and the schools to the south.

* * *

>n
far north hall
You are in far north hall. You see Lola's and Lana's room to the west, stairs to the east, and north hall to the south.

>s
north hall
You are in north hall. you see Lori's and Leni's room to the east, Luan's and Luna's room to the west, hallway to the south, and far north hall to the north.

* * *

>e
Lisa's and Lily's room
Now you are in Lisa's and Lily's room. You see Lisa working on a device and Lily in her crib.

You can see Lisa and Locked safe (in which is Quarter 3) here.

>take Quarter 3
Taken.

* * *

>n
north hall
You are in the north hall. you see Lori's and Leni's room to the east, Luan's and Luna's room to the west, hallway to the south, and far north hall to the north.

>d
You can't go that way.

* * *

>e
Living room
You are in the Living room. You see Lynn to the north, Lola and Lana to the south, and stairs to the west.

>s
South Living room
You see Living room to the north and the basement stairs to the south.

You can see Lola, and

You can see Lana here.

* * *

>s
Basement
You see Lola and Lana to the north.

You can see Couch 2 and a Video game concle here.

I beg your pardon?

>x Video game concle
The Video game concle has Nickolodeon written on the side and you need to save up to buy the video game for it.

* * *

>n
north hall
You are in the north hall. you see Lori's and Leni's room to the east, Luan's and Luna's room to the west, hallway to the south, and far north hall to the north.

>s
Royal Woods Main Street
You can see a video game shop to the north, your house to the west, and the schools to the south.

>e
Royal Woods Main Street
You can see a video game shop to the north, your house to the west, and the schools to the south.

You can see Bully here.

>s
Royal Woods School Grounds
These bullies come to stop you from entering unless you give them money. You see the inside of the school to the south, and Royal Woods Main Street to the north.

* * *

>u
Football Stadium
The Football game is about to start, and guess who your playing against- Lynn! She says "Wow, Lincoln! I didn't know that you were coming to the same football game as me!"

You can see a ball and a Scoring post here.

>throw ball at Post
(first taking the ball)
You throw the ball into the scoring post, and you won the game! The same bully from earlier hands you $500. You decide to split it evenly between your ten sisters- that means $45 each- exactly enough!

You aren't holding the ball.

>d
Royal Woods School Grounds
These bullies come to stop you from entering unless you give them money. You see the inside of the school to the south, and Royal Woods Main Street to the north.

You can see Bully and Locked safe 3 (closed) here.

* * *

>give $45 to owner
"Thank you for buying from Royal Woods Video Game shop," said the owner. "oh, and don't forget that you can play your video game in the room under the room under the basement."

You aren't holding $45.

>x cards
You see nothing special about collectable cards.

* * *

>give $45 to owner
"Thank you for buying from Royal Woods Video Game shop," said the owner. "oh, and don't forget that you can play your video game in the room under the room under the basement."

You aren't holding $45.

>x cards
Now you have your own background to look at for the rest of the game!

>s
Royal Woods Main Street
You can see a video game shop to the north, your house to the west, and the schools to the south.

* * *

>n
North Living room
You can see Lynn to the south.

You can see Couch 1 (in which is Quarter 4) here.

I beg your pardon?

>w
Lynn's and Lucy's room
Now you are in Lynn's and Lucy's room. Only Lucy is inside. You see a coffin. The only way out is back east.

You can see a coffin here.

>x coffin
Dank.  Dark.  Dismal.

* * *

>n
North Living room
You can see Lynn to the south.

You can see Couch 1 (in which is Quarter 4) here.

>s
Royal Woods School Grounds
These bullies come to stop you from entering unless you give them money. You see the inside of the school to the south, and Royal Woods Main Street to the north.

You can see Bully and Locked safe 3 (closed) here.

* * *

>i
You are carrying:
  Quarter 4
  Quarter 2
  Quarter 3
  Quarter 1

>give quarters to lola
Lola is excited and hands you a dollar bill.

>i
You are carrying:
  a Dollar Bill

>x bill
You see nothing special about the Dollar Bill.

>l
South Living room
You see Living room to the north and the basement stairs to the south.

You can see Lola and Lana here.

>s
Basement
You see Lola and Lana to the north.

You can see Couch 2 and a Video game concle here.

>x concle
The Video game concle has Nickolodeon written on the side and you need to save up to buy the video game for it.

>console
That's not a verb I recognise.

>l
Basement
You see Lola and Lana to the north.

You can see Couch 2 and a Video game concle here.

>sit on couch
That's not something you can sit down on.

>l
Basement
You see Lola and Lana to the north.

You can see Couch 2 and a Video game concle here.

>n
South Living room
You see Living room to the north and the basement stairs to the south.

You can see Lola and Lana here.

* * *

>e
Royal Woods Main Street
You can see a video game shop to the north, your house to the west, and the schools to the south.

>n
You can't go that way.

>n
You can't go that way.

>l
Royal Woods Main Street
You can see a video game shop to the north, your house to the west, and the schools to the south.

>x shop
You can't see any such thing.

>e
You can't go that way.

>s
Royal Woods School Grounds
These bullies come to stop you from entering unless you give them money. You see the inside of the school to the south, and Royal Woods Main Street to the north.

You can see Bully and Locked safe 3 (closed) here.

>x bully
He is holding a jar of money, and he wants you to give him a dollar bill to pass through.

>open safe
It seems to be locked.

>unlock safe
(with the Dollar Bill)
That doesn't seem to fit the lock.

>give bill to bully
"Come on in," said the Bully. "Oh, and, the football stadium is above here."

You aren't holding the Dollar Bill.

>i
You are carrying nothing.

>l
Royal Woods School Grounds
These bullies come to stop you from entering unless you give them money. You see the inside of the school to the south, and Royal Woods Main Street to the north.

You can see Bully and Locked safe 3 (closed) here.

>u
Football Stadium
The Football game is about to start, and guess who your playing against- Lynn! She says "Wow, Lincoln! I didn't know that you were coming to the same football game as me!"

You can see a ball and a Scoring post here.

* * *

>get ball
Taken.

>throw ball at post
You lack the nerve when it comes to the crucial moment.

>d
Royal Woods School Grounds
These bullies come to stop you from entering unless you give them money. You see the inside of the school to the south, and Royal Woods Main Street to the north.

You can see Bully and Locked safe 3 (closed) here.

>throw ball at bully
You lack the nerve when it comes to the crucial moment.

>u
Football Stadium
The Football game is about to start, and guess who your playing against- Lynn! She says "Wow, Lincoln! I didn't know that you were coming to the same football game as me!"

You can see a Scoring post here.

>x post
You see nothing special about the Scoring post.

* * *

>give ball to post
You throw the ball into the scoring post, and you won the game! The same bully from earlier hands you $500. You decide to split it evenly between your ten sisters- that means 45.45 each- exactly enough!

You aren't holding the ball.

>i
You are carrying:
  $45.45

>s
You can't go that way.

>d
Royal Woods School Grounds
These bullies come to stop you from entering unless you give them money. You see the inside of the school to the south, and Royal Woods Main Street to the north.

You can see Bully and Locked safe 3 (closed) here.

* * *

>n
Royal Woods Main Street
You can see a video game shop to the north, your house to the west, and the schools to the south.

>n
You can't go that way.

>go shop
You can't see any such thing.

>n
You can't go that way.

* * *

>l
Royal Woods Main Street
You can see a video game shop to the north, your house to the west, and the schools to the south.

>n
You can't go that way.

>enter shop
You can't see any such thing.

>i
You are carrying:
  $45.45

* * *

>s
Royal Woods Main Street
You can see a video game shop to the north, your house to the west, and the schools to the south.

>undo
video game shop
[Previous turn undone.]

>undo
video game shop
[Previous turn undone.]

>x cards
You see nothing special about collectable cards.

>undo
video game shop
[Previous turn undone.]

* * *

>s
Royal Woods School Grounds
These bullies come to stop you from entering unless you give them money. You see the inside of the school to the south, and Royal Woods Main Street to the north.

You can see Bully and Locked safe 3 (closed) here.

>n
!!!

Royal Woods Main Street
You can see a video game shop to the north, your house to the west, and the schools to the south.

>s
Royal Woods School Grounds
These bullies come to stop you from entering unless you give them money. You see the inside of the school to the south, and Royal Woods Main Street to the north.

You can see Bully and Locked safe 3 (closed) here.

* * *

>n
North Living room
You can see Lynn to the south.

You can see Couch 1 (in which is Quarter 4) here.

>x cards
You see nothing special about collectable cards.

* * *

>n
North Living room
You can see Lynn to the south.

You can see Couch 1 (in which is Quarter 4) here.

>talk to couch
Couch 1 remains silent.

>s
Lynn's area
You entered the area where Lynn excercises. You see the Living room to the south, and a couch to the north.

You can see Lynn and Lynn's hair here.

>talk to Lynn
She says, "I'm trying to excercise for my football game. I've been excercising for about 5 hours straight." You ask her both how she hasn't gotten tired, and why she hasn't used the bathroom for 5 hours. She answers with "1, I don't really get tired unless it's night time, and 2, it's bad luck to use the bathroom before a football game- if I go number 2, I can't be number 1." You see her excercise so hard that a bit of her hair falls off.

* * *

Lynn's area
You entered the area where Lynn excercises. You see the Living room to the south, and a couch to the north.

You can see Lynn and Lynn's hair here.

Loud House 'game on'
An Interactive Fiction by Caleb Wilson
Release 1 / Serial number 210525 / Inform 7 build 6M62 (I6/v6.33 lib 6/12N) SD

Lynn's area
You entered the area where Lynn excercises. You see the Living room to the south, and a couch to the north.

You can see Lynn and Lynn's hair here.

>north
hallway
Now you are in the hallway.  You can go back south, or west to Lynn's and Lucy's room or east to Lisa's and Lily's room or north for northern hallway.

>west
You can't go that way.

* * *

>north
hallway
Now you are in the hallway.  You can go back south, or west to Lynn's and Lucy's room or east to Lisa's and Lily's room or north for northern hallway.

>w
Lynn's and Lucy's room
Now you are in Lynn's and Lucy's room. Only Lucy is inside. The only way out is back east.

You can see a coffin (in which is Quarter 1) here.

>take quarter 1
Taken.

>e
hallway
Now you are in the hallway.  You can go back south, or west to Lynn's and Lucy's room or east to Lisa's and Lily's room or north for northern hallway.

>s
Your Room
You need money to buy a video game.  You can go north to the hallway.

* * *

>e
Lori's and Leni's room
 You see north hall to the west.

All you see are Leni's bed, Lori's bed and a dresser.

>check bed
Which do you mean, Leni's bed or Lori's bed?

>leni's bed
You check Leni's bed, but all you see are clothes and dolls.

>check lori's bed
You check Lori's bed, and you find Lori's phone.

On Lori's bed is Lori's phone.

>x phone
You turn on Lori's phone, and you see an advertisement for proffessional kids football. It says that only athletes 10 to 15 (of course, you're 11) can enter. it's a $1 entry fee, and if you win, you'll earn $500! You should keep that in mind. Just collect 4 Quarters and become an athlete to enter.

>x dresser
In the dresser is Quarter 2.

>take quarter 2
Taken.

>w
north hall
You are in north hall. you see Lori's and Leni's room to the east, Luan's and Luna's room to the west, hallway to the south, and far north hall to the north.

* * *

>s
hallway
Now you are in the hallway.  You can go back south, or west to Lynn's and Lucy's room or east to Lisa's and Lily's room or north for northern hallway.

>n
north hall
You are in north hall. you see Lori's and Leni's room to the east, Luan's and Luna's room to the west, hallway to the south, and far north hall to the north.

* * *

>w
Luan's and Luna's room
You are in Luan's and Luna's room. You see north hall to the east.

You can see Luan, Luna, a puppet and a speaker here.

>x puppet
You check the puppet, and it's full of loose change! Slight problem: It's not LOOSE change- It's actually Luan's "wallet". You can't take that.

>x speaker
You check every inch of the speaker, but no loose change found.

>talk to luan
You try to ask Luan for advice on how to make money, but she inturupts with a joke. "why did the chicken cross the road? To prove it wasn't a chicken!" She laughs at her own joke.

>s
You can't go that way.

* * *

>n
You can't go that way.

>e
north hall
You are in north hall. you see Lori's and Leni's room to the east, Luan's and Luna's room to the west, hallway to the south, and far north hall to the north.

>n
far north hall
You are in far north hall. You see Lola's and Lana's room to the west, stairs to the east, and north hall to the south.

>stairs
That's not a verb I recognise.

>e
Living room
You are in the Living room. You see Lynn to the north, Lola and Lana to the south, stairs to the west, and the exit to the east.

* * *

>n
Lynn's area
You entered the area where Lynn excercises. You see the Living room to the south, and a couch to the north.

You can see Lynn and Lynn's hair here.

>x hair
This is part of Lynn's hair. It's useful if you need a DNA sample of her.

>take hair
Taken.

>s
Living room
You are in the Living room. You see Lynn to the north, Lola and Lana to the south, stairs to the west, and the exit to the east.

>s
South Living room
You see Living room to the north and the basement stairs to the south.

You can see Lola and Lana here.

>talk to lola
She says, "I don't have much time to talk right now- I'm getting my go-kart repaired. But if you have four Quarters to trade with me for a dollar, then I'm listening."

>talk to lana
She says, "You know, I learned how to plumb, like the taste of mud, and how to repair cars through Lori's phone- maybey you should check her phone, too." She goes back to repairing Lola's go-kart.

>s
Basement
You see Lola and Lana to the north.

You can see Couch 2 and a Video game concle here.

>x couch 2
You examine the entire couch, but no loose change found.

>x video game console
I only understood you as far as wanting to examine the Video game concle.

>x video game concie
I only understood you as far as wanting to examine the Video game concle.

>x video game concle
The Video game concle has Nickolodeon written on the side and you need to save up to buy the video game for it.

>n
South Living room
You see Living room to the north and the basement stairs to the south.

You can see Lola and Lana here.

* * *

>n
Living room
You are in the Living room. You see Lynn to the north, Lola and Lana to the south, stairs to the west, and the exit to the east.

>x living room
You can't see any such thing.

>n
Lynn's area
You entered the area where Lynn excercises. You see the Living room to the south, and a couch to the north.

You can see Lynn here.

>talk to lynn
She says, "I'm trying to excercise for my football game. I've been excercising for about 5 hours streight." You ask her both how she hasn't gotten tired, and why she hasn't used the bathroom for 5 hours. She answers with "1, I don't really get tired unless it's night time, and 2, it's bad luck to use the bathroom before a football game- if I go number 2, I can't be number 1." You see her excercise so hard that a bit of her hair falls off.

>i
You are carrying:
  Lynn's hair
  Quarter 2
  Quarter 1

>n
North Living room
You can see Lynn to the south.

You can see Couch 1 (in which is Quarter 4) here.

* * *

>x couch 1
You examine the Couch, and...

In Couch 1 is Quarter 4.

>take quarter 4
Taken.

>go upstairs
You can't see any such thing.

>n
You can't go that way.

>s
Lynn's area
You entered the area where Lynn excercises. You see the Living room to the south, and a couch to the north.

You can see Lynn here.

>e
You can't go that way.

* * *

>w
You can't go that way.

>n
North Living room
You can see Lynn to the south.

You can see Couch 1 (empty) here.

* * *

>w
far north hall
You are in far north hall. You see Lola's and Lana's room to the west, stairs to the east, and north hall to the south.

>e
Living room
You are in the Living room. You see Lynn to the north, Lola and Lana to the south, stairs to the west, and the exit to the east.

>w
far north hall
You are in far north hall. You see Lola's and Lana's room to the west, stairs to the east, and north hall to the south.

>w
Lola's and Lana's room
You enter Lola's and Lana's room. You see far north hall to the east.

You can see a mirror, a teacup, a frog cage and Locked safe 2 (closed) here.

>e
far north hall
You are in far north hall. You see Lola's and Lana's room to the west, stairs to the east, and north hall to the south.

* * *

>e
Lisa's and Lily's room
Now you are in Lisa's and Lily's room. You see Lisa working on a device and Lily in her crib.

You can see Lisa and Locked safe (closed) here.

>talk to lisa
"I am working on a device to turn a regular kid into an athlete! It requires DNA from someone who's good at sports, though." Now where can you find an athlete kid that's good at sports?

>give hair to lisa
Lisa is excited that you gave her Lynn's hair, and she blasts you with the athlete ray. She also gives you a Quarter.

>s
You can't go that way.

* * *

>e
You can't go that way.

>n
You can't go that way.

>w
hallway
Now you are in the hallway.  You can go back south, or west to Lynn's and Lucy's room or east to Lisa's and Lily's room or north for northern hallway.

* * *

I beg your pardon?

>examine bully
He is holding a jar of money, and he wants you to give him a dollar bill to pass through.

>n
Royal Woods Main Street
You can see a video game shop to the north, your house to the west, and the schools to the south.

* * *

I beg your pardon?

>examine owner
You see nothing special about the owner.

>s
Royal Woods Main Street
You can see a video game shop to the north, your house to the west, and the schools to the south.

>w
Living room
You are in the Living room. You see Lynn to the north, Lola and Lana to the south, stairs to the west, and the exit to the east.

>talk to lynn
You can't see any such thing.

>s
South Living room
You see Living room to the north and the basement stairs to the south.

You can see Lola and Lana here.

* * *

>talk to lola
She says, "I don't have much time to talk right now- I'm getting my go-kart repaired. But if you have four Quarters to trade with me for a dollar, then I'm listening."

>give 4 quarters to lola
Only one of those is available.

>give quarters to lola
Lola is excited and hands you a dollar bill.

>s
Basement
You see Lola and Lana to the north.

You can see Couch 2 and a Video game concle here.

* * *

>s
Royal Woods School Grounds
These bullies come to stop you from entering unless you give them money. You see the inside of the school to the south, and Royal Woods Main Street to the north.

You can see Bully and Locked safe 3 (closed) here.

>examine safe
You see nothing special about Locked safe 3.

* * *

>examine bully
He is holding a jar of money, and he wants you to give him a dollar bill to pass through.

>give dollar
(to Bully)
"Come on in," said the Bully. "Oh, and, the football stadium is above here."

You aren't holding the Dollar Bill.

>u
Football Stadium
The Football game is about to start, and guess who your playing against- Lynn! She says "Wow, Lincoln! I didn't know that you were coming to the same football game as me!"

You can see a ball and a Scoring post here.

>talk to lynn
You can't see any such thing.

>examine stadium
You can't see any such thing.

>examine lynn
You can't see any such thing.

>throw ball at scoring post
(first taking the ball)
You throw the ball into the scoring post, and you won the game! The same bully from earlier hands you $500. You decide to split it evenly between your ten sisters- that means $45 each- exactly enough!

You aren't holding the ball.

>n
You can't go that way.

* * *

>w
You can't go that way.

>d
Royal Woods School Grounds
These bullies come to stop you from entering unless you give them money. You see the inside of the school to the south, and Royal Woods Main Street to the north.

You can see Bully and Locked safe 3 (closed) here.

* * *

>n
video game shop
You are in the video game shop. Here you can buy that video game + collectable rare cards for just $45!

You can see an owner and Locked safe 4 (closed) here.

>buy game
You can't see any such thing.

>buy video game
You can't see any such thing.

>give $45 to owner
"Thank you for buying from Royal Woods Video Game shop," said the owner. "oh, and don't forget that you can play your video game in the room under the room under the basement."

You aren't holding $45.

>e
You can't go that way.

* * *

>w
You can't go that way.

>s
Royal Woods Main Street
You can see a video game shop to the north, your house to the west, and the schools to the south.

* * *

>w
Living room
You are in the Living room. You see Lynn to the north, Lola and Lana to the south, stairs to the west, and the exit to the east.

>s
South Living room
You see Living room to the north and the basement stairs to the south.

You can see Lola and Lana here.

>s
Basement
You see Lola and Lana to the north.

You can see Couch 2 and a Video game concle here.

>play video game
That's not a verb I recognise.

>find video game
That's not a verb I recognise.

>d
Secret Passageway
So, I guess you found my secret room. Either you beat the game, or you found a hack to it. If the first one, good job! Well, you know where to go from here.

* * *

>n
Bikini Bottom
you  see your Pineapple house to the south and the Krusty Krab to the north.

You can see Plankton's robot here.

>talk to plankton
You can't see any such thing.

>examin plankton
That's not a verb I recognise.

>examine plankton's robot
You see nothing special about Plankton's robot.

>n
Krusty Krab
You see Bikini Bottom to the south.

You can see mister Krabs, Locked safe 5 (closed) and Krabby Patty dresser (in which is Dollar Bill 2) here.

>examine dresser
In Krabby Patty dresser is Dollar Bill 2.

>take dollar bill 2
Taken.

>n
You can't go that way.

I beg your pardon?

* * *

>e
You can't go that way.

>s
Bikini Bottom
you  see your Pineapple house to the south and the Krusty Krab to the north.

You can see Plankton's robot here.

>s
Pineapple house
You can go north.

You can see Gary here.

* * *

I beg your pardon?

>examine gary
He is a snail with a spiral shell.

>examine pineapple house
You can't see any such thing.

>look inside house
You can't see any such thing.

>i
You are carrying:
  Dollar Bill 2
  collectable cards

>n
Bikini Bottom
you  see your Pineapple house to the south and the Krusty Krab to the north.

You can see Plankton's robot here.

>n
Krusty Krab
You see Bikini Bottom to the south.

You can see mister Krabs, Locked safe 5 (closed) and Krabby Patty dresser (empty) here.

* * *

I beg your pardon?

>examine mister krabs
You see nothing special about mister Krabs.

>give dollar to mister krabs
mister Krabs's eyes show dollar sighns and he hands you a Krabby Patty.

You aren't holding Dollar Bill 2.

>s
Bikini Bottom
you  see your Pineapple house to the south and the Krusty Krab to the north.

You can see Plankton's robot here.

>throw krabby patty at plankton's robot
you throw the Krabby Patty at the robot, and you've saved Bikini Bottom!

You aren't holding Krabby Patty.

>i
You are carrying:
  Gamer Pass 1
  collectable cards

>s
Pineapple house
You can go north.

You can see Gary here.

* * *

>s
Chipmunk house
You can see the exit to the south or you can leave the game by going north.

You can see Dave here.

>talk to dave
Dave asks "Have you seen my computer?"

>no
That was a rhetorical question.

>examine dave
You see nothing special about Dave.

>examine room
You can't see any such thing.

>e
You can't go that way.

* * *

>w
You can't go that way.

>s
Neighborhood
You can see your house to the north, and The Tree house to the south.

You can see evil robot here.

* * *

>s
Tree house
You are in The Tree house. You can leave to the north.

You can see Dave's computer here.

>take dave's computer
Taken.

>n
Neighborhood
You can see your house to the north, and The Tree house to the south.

You can see evil robot here.

* * *

>n
Chipmunk house
You can see the exit to the south or you can leave the game by going north.

You can see Dave here.

>give computer to dave
Dave is excited and gives you a squirt gun as a reward. Maybey you could use this to fight the evil robot.

You aren't holding Dave's computer.

>s
Neighborhood
You can see your house to the north, and The Tree house to the south.

You can see evil robot here.

>squirt gun the evil robot
That's not a verb I recognise.

>squirt the evil robot
That's not a verb I recognise.

>throw squirt gun at evil robot
you throw the squirt gun at the robot, and the water tank explodes, getting water into the robots systems, shutting it down.

You aren't holding the squirt gun.

>i
You are carrying:
  Gamer Pass 2
  Gamer Pass 1
  collectable cards

>i gamer pass 2
I only understood you as far as wanting to take inventory.

>x gamer pass 2
You earned this by beating the evil robot that attacked the neighboorhood. If you give this to the owner of the video game shop, and collect all the other ones, you'll unlock a secret minigame.

>x gamer pass 1
You earned this by beating Plankton's Robot. If you give this to the owner of the video game shop, and collect all the other ones, you'll unlock a secret minigame.

>n
Chipmunk house
You can see the exit to the south or you can leave the game by going north.

You can see Dave here.

* * *

>w
Man-cave
You can leave the Man-cave by going up.

You can see a space key here.

>take space key
Taken.

>s
You can't go that way.

* * *

>n
You can't go that way.

>e
Nickolodeon game
You can play the Spongebob game to the north, Alvin and the chipmunks to the south, Henry Danger to the west, and Teenage Mutant Ninja Turtles to the east. Go up twice to leave.

You can see Game Gate here.

>w
Man-cave
You can leave the Man-cave by going up.

>w
You can't go that way.

>u
Swellview
Oh no! There's now an alien invasion from Mars! Go down to enter the Man-Cave, or go west to enter the rocket and get to Mars.

You can see a rocket and Marty here.

>w
(first opening the rocket)
It seems to be locked.

* * *

>e
You can't go that way.

>take rocket
That's fixed in place.

>unlock rocket
What do you want to unlock the rocket with?

* * *

>w
(first opening the rocket)

Mars
You are now on Mars. You can go west to the Canyon or east to get back to earth.

You can see a rocket and a Translater here.

>take rocket and translater
rocket: That's fixed in place.
Translater: Taken.

>unlock rocket
What do you want to unlock the rocket with?

>key
That's unlocked at the moment.

>w
Canyon
You are now on the Mountian. You can see Mars to the east.

You can see a rover here.

>take rover
I don't suppose the rover would care for that.

>talk to rover
the rover says "Beep Boop Beep."

>use translater
That's not a verb I recognise.

>translate
That's not a verb I recognise.

>give translater to rover
The rover can now say stuff in english. it says "Oh, Wow! I can speak human language! Hey, I need you to give me this special alien bug in the valley to the west so my human controllers can finally stop searching and take me off this planet once and for all!"

You aren't holding the Translater.

>w
Valley
You are in the Valley. You see the Canyon to the east.

You can see an Alien Bug here.

>take alien bug
Taken.

>e
Canyon
You are now on the Mountian. You can see Mars to the east.

You can see a rover here.

I beg your pardon?

>give alien bug to rover
You give the Alien Bug to the rover and it says "Oooh! Now I can report it to NASA!" He hands you an Omega Grenade.

You aren't holding the Alien Bug.

>e
Mars
You are now on Mars. You can go west to the Canyon or east to get back to earth.

You can see a rocket here.

>w
Canyon
You are now on the Mountian. You can see Mars to the east.

You can see a rover here.

>e
Mars
You are now on Mars. You can go west to the Canyon or east to get back to earth.

You can see a rocket here.

* * *

>e
Swellview
Oh no! There's now an alien invasion from Mars! Go down to enter the Man-Cave, or go west to enter the rocket and get to Mars.

You can see a rocket and Marty here.

>throw omega grenade at marty
You did it! You blew up the alien invaders and saved swellview!

You aren't holding the Omega Grenade.

>i
You are carrying:
  Gamer Pass 3
  a space key
  Gamer Pass 2
  Gamer Pass 1
  collectable cards

>e
You can't go that way.

>w
Mars
You are now on Mars. You can go west to the Canyon or east to get back to earth.

You can see a rocket here.

>d
You can't go that way.

>e
Swellview
Oh no! There's now an alien invasion from Mars! Go down to enter the Man-Cave, or go west to enter the rocket and get to Mars.

You can see a rocket and Marty here.

>n
You can't go that way.

>d
Man-cave
You can leave the Man-cave by going up.

* * *

>n
You can't go that way.

>u
City
You are in the city. You see a sai target to the east and your sewer under you.

You can see a Guard here.

* * *

I beg your pardon?

>examine guard
He has completely sword-proof armor, but his head looks easy to hit.

>hit guard with sword
I only understood you as far as wanting to hit the Guard.

>e
Target gate
You are in the City. You see Shredder's Castle to the east.

You can see Castle Gate and a sai target here.

>hit sai target with sword
I only understood you as far as wanting to hit the sai target.

>hit sai targer
I only understood you as far as wanting to hit the sai target.

>hit sai target
Violence isn't the answer to this one.

>throw sai at sai target
(first taking the sai target)
I don't suppose the sai target would care for that.

>i
You are carrying:
  Mike's nun-chucks
  Leo's sword
  Locked safe 6 (closed and locked)
  Gamer Pass 3
  a space key
  Gamer Pass 2
  Gamer Pass 1
  collectable cards

>w
City
You are in the city. You see a sai target to the east and your sewer under you.

You can see a Guard here.

>throw nun-chucks at guard
You knock him out and win your sai back.

You aren't holding Mike's nun-chucks.

>e
Target gate
You are in the City. You see Shredder's Castle to the east.

You can see Castle Gate and a sai target here.

>throw sai at sai target
(Raph's sai at the sai target)
You throw the sai and hit the target, scoring the key to the gate!

You aren't holding Raph's sai.

>open gate
It seems to be locked.

>unlock gate
What do you want to unlock Castle Gate with?

* * *

>key
Which do you mean, the Skull Key or the space key?

>skull key
You unlock Castle Gate.

>examine
What do you want to examine?

>castle gate
You see nothing special about Castle Gate.

>enter
You must supply a noun.

>e
(first opening Castle Gate)

Shredder's Castle
You are in Shredder's Castle! You see Target gate to the west.

You can see Castle Gate and Shredder here.

>examine shredder
He is wearing armor that is proof to all metals except iron.

>attack shredder with sword
I only understood you as far as wanting to attack Shredder.

>throw sword
Dropped.

>take sword
Taken.

>examin sword
That's not a verb I recognise.

>x sword
It is made mostly out of iron.

>throw sword at shredder
You throw the sword, and it cuts through Shredder's armor, killing him.

You aren't holding Leo's sword.

>i
You are carrying:
  Gamer Pass 4
  a Skull Key
  Locked safe 6 (closed and locked)
  Gamer Pass 3
  a space key
  Gamer Pass 2
  Gamer Pass 1
  collectable cards

>u
You can't go that way.

>d
You can't go that way.

>e
You can't go that way.

>w
Target gate
You are in the City. You see Shredder's Castle to the east.

You can see Castle Gate and a sai target here.

* * *

>n
video game shop
You are in the video game shop. Here you can buy that video game + collectable rare cards for just $45!

You can see an owner and Locked safe 4 (closed) here.

>give game passes to owner
You can't see any such thing.

>give gamer passes to owner
the owner says, "I see you've played your new game." He hands you a game key. "This should unlock a secret level. It is below the menu."

>s
Royal Woods Main Street
You can see a video game shop to the north, your house to the west, and the schools to the south.

* * *

>s
Basement
You see Lola and Lana to the north.

You can see Couch 2 and a Video game concle here.

>d
Secret Passageway
So, I guess you found my secret room. Either you beat the game, or you found a hack to it. If the first one, good job! Well, you know where to go from here.

* * *

>d
Nickolodeon game
You can play the Spongebob game to the north, Alvin and the chipmunks to the south, Henry Danger to the west, and Teenage Mutant Ninja Turtles to the east. Go up twice to leave.

You can see Game Gate here.

>unlock game gate
What do you want to unlock Game Gate with?

>key
Which do you mean, the Game Key, the Skull Key or the space key?

>game key
You unlock Game Gate.

>d
(first opening Game Gate)

Slime Boss
You can go up to the menu, or west once you get your first Key.

You can see Game Gate 2, Game Gate, a Slime monster, a dinosaur, a skate-board and a Lion here.

>talk to slime monster
The Slime monster says, "Here's your first riddle. Now this is something that roars- and it's called a ________. Throw the answer at me to recieve your first key.

>lion
That's not a verb I recognise.

>throw lion
The Lion is already here.

>throw skate-board
The skate-board is already here.

>throw lion at slime monster
(first taking the Lion)
The Slime monster doesn't seem interested.

>throw skate-board at slime monster
(first taking the skate-board)
The Slime monster doesn't seem interested.

>throw dinosaur at slime monster
(first taking the dinosaur)
You throw the dinosaur at the Slime monster, and it's impressed. "Here's your first key," he says.

You aren't holding the dinosaur.

>x cards
Now you have your own background to look at for the rest of the game!

>unlock game gate 2
What do you want to unlock Game Gate 2 with?

>key
Which do you mean, Game Key 2, the Game Key, the Skull Key or the space key?

>game key 2
You unlock Game Gate 2.

>w
(first opening Game Gate 2)

Slime Boss 2
You can go east than up to leave the Boss, or go west once you have the Key.

You can see Game Gate 3, Game Gate 2, Slime monster 2, a Charged wire and a Fire here.

>talk to slime monster 2
The Slime monster says, "Here's your second riddle- and it won't be easy like the last one. Now, this object will destroy me: Kaboom! Kabwire! and this is called a ____. Throw the answer at me to earn your second key.

>throw the charged wire at the slime monster
(first taking the Charged wire)
Slime monster 2 doesn't seem interested.

>throw the fire at the slime monster
(first taking the Fire)
You throw the Fire at the Slime monster, Causing him to scream in pain as half of him burns off.

You aren't holding the Fire.

>i
You are carrying:
  Game Key 3
  a Charged wire
  Game Key 2
  a skate-board
  a Lion
  a Game Key
  a Skull Key
  Locked safe 6 (closed and locked)
  a space key
  collectable cards

>unlock game gate 3
What do you want to unlock Game Gate 3 with?

>game key 3
You unlock Game Gate 3.

>w
(first opening Game Gate 3)

Slime Boss 3
You can go east twice than up to leave the Boss, or go west once you have the key to end the game.

You can see Game Gate 3, Slime monster 3, Pringle Chips, a Knife and Citric acid here.

>talk to slime monster
The Slime monster says, "Here's your final riddle: use your Logic and Science- which one will completly destroy me?

>throw the pringle chips
Pringle Chips is already here.

>throw pringle chips at the slime monster
(first taking Pringle Chips)
You throw the Chips at the Slime monster, and the vinegar is making him disinagrate. He drops the final key, and you take it.

You aren't holding Pringle Chips.

>unlock game gate 4
I didn't understand that sentence.

>i
You are carrying:
  Game Key 3
  a Charged wire
  Game Key 2
  a skate-board
  a Lion
  a Game Key
  a Skull Key
  Locked safe 6 (closed and locked)
  a space key
  collectable cards

>w
You can't go that way.

* * *

Lynn's area
You entered the area where Lynn excercises. You see the Living room to the south, and a couch to the north.

You can see Lynn and Lynn's hair here.

Loud House 'game on'
An Interactive Fiction by Caleb Wilson
Release 1 / Serial number 210525 / Inform 7 build 6M62 (I6/v6.33 lib 6/12N) SD

Lynn's area
You entered the area where Lynn excercises. You see the Living room to the south, and a couch to the north.

You can see Lynn and Lynn's hair here.

>i
You are carrying:
  a mysterious orb

>give quarter to lola
Which do you mean, Quarter 4, Quarter 2, Quarter 3 or Quarter 1?

>give quarter 1 to lola
Lola is excited and hands you a dollar bill.

>i
You are carrying nothing.

>restart
Are you sure you want to restart?

>'y
Please answer yes or no.

>y
South Living room
You see Living room to the north and the basement stairs to the south.

You can see Lola and Lana here.

Loud House 'game on'
An Interactive Fiction by Caleb Wilson
Release 1 / Serial number 210503 / Inform 7 build 6M62 (I6/v6.33 lib 6/12N) SD

South Living room
You see Living room to the north and the basement stairs to the south.

You can see Lola and Lana here.

>give all quarters to lola
You can't use multiple objects with that verb.

* * *

>i
You are carrying:
  a mysterious orb

>n
Living room
You are in the Living room. You see Lynn to the north, Lola and Lana to the south, stairs to the west, and the exit to the east.

* * *

>throw ball at post
You throw the ball into the scoring post, and you won the game! The same bully from earlier hands you $500. You decide to split it evenly between your ten sisters- that means 45.45 each- exactly enough!

You aren't holding the ball.

>i
You are carrying:
  $45 45
  Quarter 4
  Quarter 2
  Quarter 3
  Quarter 1

>drop 45 45
Dropped.

>l
Football Stadium
The Football game is about to start, and guess who your playing against- Lynn! She says "Wow, Lincoln! I didn't know that you were coming to the same football game as me!"

You can see $45 45 and a Scoring post here.

>get 45 45
Taken.

* * *

>i
You are carrying:
  a mysterious orb

>e
Nickolodeon game
You can play the Spongebob game to the north, Alvin and the chipmunks to the south, Henry Danger to the west, and Teenage Mutant Ninja Turtles to the east. Go up twice to leave.

You can see Game Gate here.

* * *

>e
You can't go that way.

>n
Living room
You are in the Living room. You see Lynn to the north, Lola and Lana to the south, stairs to the west, and the exit to the east.

* * *

>give game passes to owner
You can't see any such thing.

>give gamer passes to owner
You can't use multiple objects with that verb.

>give Gamer Passes to owner
You can't use multiple objects with that verb.

>i
You are carrying:
  Gamer Pass 4
  Gamer Pass 3
  Gamer Pass 2
  Gamer Pass 1

>give Gamer Passes to the owner
You can't use multiple objects with that verb.

>give Gamer Passes to the owner
You can't use multiple objects with that verb.

I beg your pardon?

>give Gamer Passes to the owner
You can't use multiple objects with that verb.

>give Gamer Pass 1 to the owner
the owner says, "I see you've played your new game." He hands you a game key. "This should unlock a secret level. It is below the menu."

* * *

>n
video game shop
You are in the video game shop. Here you can buy that video game + collectable rare cards for just $45!

You can see an owner and Locked safe 4 (closed) here.

>give gamer passes to owner
You can't use multiple objects with that verb.

* * *

>i
You are carrying:
  a mysterious orb

>x cards
You see nothing special about collectable cards.

>l
Man-cave
You can leave the Man-cave by going up.

You can see a space key here.

>e
Nickolodeon game
You can play the Spongebob game to the north, Alvin and the chipmunks to the south, Henry Danger to the west, and Teenage Mutant Ninja Turtles to the east. Go up twice to leave.

You can see Game Gate here.

* * *

>u
Secret Passageway
So, I guess you found my secret room. Either you beat the game, or you found a hack to it. If the first one, good job! Well, you know where to go from here.

>n
You can't go that way.

* * *

>e
You can't go that way.

>u
Basement
You see Lola and Lana to the north.

You can see Couch 2 and a Video game concle here.

* * *

>e
You can't go that way.

>s
Basement
You see Lola and Lana to the north.

You can see Couch 2 and a Video game concle here.

>e
You can't go that way.

>nu
That's not a verb I recognise.

>u
You can't go that way.

>n
South Living room
You see Living room to the north and the basement stairs to the south.

You can see Lola and Lana here.

* * *

>s
Royal Woods School Grounds
These bullies come to stop you from entering unless you give them money. You see the inside of the school to the south, and Royal Woods Main Street to the north.

You can see Bully and Locked safe 3 (closed) here.

>x cards
You see nothing special about collectable cards.

* * *

>n
Royal Woods Main Street
You can see a video game shop to the north, your house to the west, and the schools to the south.

>s
Royal Woods School Grounds
These bullies come to stop you from entering unless you give them money. You see the inside of the school to the south, and Royal Woods Main Street to the north.

You can see Bully and Locked safe 3 (closed) here.

* * *

Lynn's area
You entered the area where Lynn excercises. You see the Living room to the south, and a couch to the north.

You can see Lynn and Lynn's hair here.

Loud House 'game on'
An Interactive Fiction by Caleb Wilson
Release 1 / Serial number 210525 / Inform 7 build 6M62 (I6/v6.33 lib 6/12N) SD

Lynn's area
You entered the area where Lynn excercises. You see the Living room to the south, and a couch to the north.

You can see Lynn and Lynn's hair here.

>give all to lola
You can't use multiple objects with that verb.

>give quarters to lola
You can't see any such thing.

>give coin to lola
You can't see any such thing.

* * *

Lynn's area
You entered the area where Lynn excercises. You see the Living room to the south, and a couch to the north.

You can see Lynn and Lynn's hair here.

Loud House 'game on'
An Interactive Fiction by Caleb Wilson
Release 1 / Serial number 210525 / Inform 7 build 6M62 (I6/v6.33 lib 6/12N) SD

Lynn's area
You entered the area where Lynn excercises. You see the Living room to the south, and a couch to the north.

You can see Lynn and Lynn's hair here.

>give quarters to lola
So far so good...
Lola is excited and hands you a dollar bill.

>i
You are carrying nothing.

* * *

>restart
Are you sure you want to restart?

>y
South Living room
You see Living room to the north and the basement stairs to the south.

You can see Lola and Lana here.

Loud House 'game on'
An Interactive Fiction by Caleb Wilson
Release 1 / Serial number 210503 / Inform 7 build 6M62 (I6/v6.33 lib 6/12N) SD

South Living room
You see Living room to the north and the basement stairs to the south.

You can see Lola and Lana here.

>s
Basement
You see Lola and Lana to the north.

You can see Couch 2 and a Video game concle here.

>drop quarter 1
Dropped.

>n
South Living room
You see Living room to the north and the basement stairs to the south.

You can see Lola and Lana here.

>give quarters to lola
You can't see any such thing.

>i
You are carrying:
  Quarter 4
  Quarter 2
  Quarter 3

* * *

>give quarters to lola
So far so good...
Lola is excited and hands you a dollar bill.

>restart
Are you sure you want to restart?

* * *

Lynn's area
You entered the area where Lynn excercises. You see the Living room to the south, and a couch to the north.

You can see Lynn and Lynn's hair here.

Loud House 'game on'
An Interactive Fiction by Caleb Wilson
Release 1 / Serial number 210525 / Inform 7 build 6M62 (I6/v6.33 lib 6/12N) SD

Lynn's area
You entered the area where Lynn excercises. You see the Living room to the south, and a couch to the north.

You can see Lynn and Lynn's hair here.

>drop quarter 2
Dropped.

>give quarters to lola
Not enough something something.

Lola doesn't seem interested.

* * *

>drop quarter 2
Dropped.

I beg your pardon?

>give quarters to lola
Not enough something something.

>get quater
You can't see any such thing.

>get quarter
(Quarter 2)
Taken.

>give quarters to lola
Not enough something something.

>i
You are carrying:
  Quarter 2
  Quarter 4
  Quarter 3
  Quarter 1

>l
South Living room
You see Living room to the north and the basement stairs to the south.

You can see Lola and Lana here.

* * *

Lynn's area
You entered the area where Lynn excercises. You see the Living room to the south, and a couch to the north.

You can see Lynn and Lynn's hair here.

Loud House 'game on'
An Interactive Fiction by Caleb Wilson
Release 1 / Serial number 210525 / Inform 7 build 6M62 (I6/v6.33 lib 6/12N) SD

Lynn's area
You entered the area where Lynn excercises. You see the Living room to the south, and a couch to the north.

You can see Lynn and Lynn's hair here.

>give quaters to lola
You can't see any such thing.

>give quarters to lola
So far so good...
Not enough something something.

* * *

Lynn's area
You entered the area where Lynn excercises. You see the Living room to the south, and a couch to the north.

You can see Lynn and Lynn's hair here.

Loud House 'game on'
An Interactive Fiction by Caleb Wilson
Release 1 / Serial number 210525 / Inform 7 build 6M62 (I6/v6.33 lib 6/12N) SD

Lynn's area
You entered the area where Lynn excercises. You see the Living room to the south, and a couch to the north.

You can see Lynn and Lynn's hair here.

>give Quarters to Lola
Lola is excited and hands you a dollar bill.

>drop quarter 3
You haven't got that.

* * *

>give Quarters to Lola
Lola is excited and hands you a dollar bill.

>i
You are carrying:
  a Dollar Bill

* * *

>give Quarters to Lola
Lola is excited and hands you a dollar bill.

>n
Living room
You are in the Living room. You see Lynn to the north, Lola and Lana to the south, stairs to the west, and the exit to the east.

* * *

>e
Royal Woods Main Street
You can see a video game shop to the north, your house to the west, and the schools to the south.

>i
You are carrying:
  a Dollar Bill

>s
Royal Woods School Grounds
These bullies come to stop you from entering unless you give them money. You see the inside of the school to the south, and Royal Woods Main Street to the north.

You can see Bully here.

>u
Football Stadium

>d
Royal Woods School Grounds
These bullies come to stop you from entering unless you give them money. You see the inside of the school to the south, and Royal Woods Main Street to the north.

You can see Bully here.

>n
Royal Woods Main Street
You can see a video game shop to the north, your house to the west, and the schools to the south.

* * *

>n
You can't go that way.

>w
Living room
You are in the Living room. You see Lynn to the north, Lola and Lana to the south, stairs to the west, and the exit to the east.

>n
Lynn's area
You entered the area where Lynn excercises. You see the Living room to the south, and a couch to the north.

You can see Lynn and Lynn's hair here.

* * *

Lynn's area
You entered the area where Lynn excercises. You see the Living room to the south, and a couch to the north.

You can see Lynn and Lynn's hair here.

Loud House 'game on'
An Interactive Fiction by Caleb Wilson
Release 1 / Serial number 210525 / Inform 7 build 6M62 (I6/v6.33 lib 6/12N) SD

Lynn's area
You entered the area where Lynn excercises. You see the Living room to the south, and a couch to the north.

You can see Lynn and Lynn's hair here.

>x lana
Lana is wearing muddy overalls (she must have been eating mud pies again) and a dirty cap.

>give Quarters to Lola
Lola is excited and hands you a dollar bill.

* * *

>s
Royal Woods School Grounds
These bullies come to stop you from entering unless you give them money. You see the inside of the school to the south, and Royal Woods Main Street to the north.

You can see Bully and Locked safe 3 (closed) here.

>x Locked safe 3
You see nothing special about Locked safe 3.

>give Dollar Bill to Bully
"Come on in," said the Bully. "Oh, and, the football stadium is above here."

You aren't holding the Dollar Bill.

>u
Football Stadium
The Football game is about to start, and guess who your playing against- Lynn! She says "Wow, Lincoln! I didn't know that you were coming to the same football game as me!"

You can see a ball and a Scoring post here.

>Take ball
Taken.

>Throw ball at scoring post
You throw the ball into the scoring post, and you won the game! The same bully from earlier hands you $500. You decide to split it evenly between your ten sisters- that means 45.45 each- exactly enough!

You aren't holding the ball.

>d
Royal Woods School Grounds
These bullies come to stop you from entering unless you give them money. You see the inside of the school to the south, and Royal Woods Main Street to the north.

You can see Bully and Locked safe 3 (closed) here.

>i
You are carrying:
  $45.45

>n
Royal Woods Main Street
You can see a video game shop to the north, your house to the west, and the schools to the south.

* * *

Lynn's area
You entered the area where Lynn excercises. You see the Living room to the south, and a couch to the north.

You can see Lynn and Lynn's hair here.

Loud House 'game on'
An Interactive Fiction by Caleb Wilson
Release 1 / Serial number 210525 / Inform 7 build 6M62 (I6/v6.33 lib 6/12N) SD

Lynn's area
You entered the area where Lynn excercises. You see the Living room to the south, and a couch to the north.

You can see Lynn and Lynn's hair here.

>drop Quarter 1
Dropped.

>give Quarters to Lola
(first taking Quarter 1)
Lola is excited and hands you a dollar bill.

>n
Living room
You are in the Living room. You see Lynn to the north, Lola and Lana to the south, stairs to the west, and the exit to the east.

* * *

>s
Royal Woods School Grounds
These bullies come to stop you from entering unless you give them money. You see the inside of the school to the south, and Royal Woods Main Street to the north.

You can see Bully and Locked safe 3 (closed) here.

>Give Dollar Bill to Bully
"Come on in," said the Bully. "Oh, and, the football stadium is above here."

You aren't holding the Dollar Bill.

>u
Football Stadium
The Football game is about to start, and guess who your playing against- Lynn! She says "Wow, Lincoln! I didn't know that you were coming to the same football game as me!"

You can see a ball and a Scoring post here.

* * *

>d
Royal Woods School Grounds
These bullies come to stop you from entering unless you give them money. You see the inside of the school to the south, and Royal Woods Main Street to the north.

You can see Bully and Locked safe 3 (closed) here.

>s
You can't go that way.

>n
Royal Woods Main Street
You can see a video game shop to the north, your house to the west, and the schools to the south.

* * *

>give $45 to owner
"Thank you for buying from Royal Woods Video Game shop," said the owner. "oh, and don't forget that you can play your video game in the room under the room under the basement."

You aren't holding $45.

>i
You are carrying:
  collectable cards

>s
Royal Woods Main Street
You can see a video game shop to the north, your house to the west, and the schools to the south.

* * *

>d
Secret Passageway
So, I guess you found my secret room. Either you beat the game, or you found a hack to it. If the first one, good job! Well, you know where to go from here.

>d
Nickolodeon Game Menu
You can play the Spongebob game to the north, Alvin and the chipmunks to the south, Henry Danger to the west, and Teenage Mutant Ninja Turtles to the east. Go up twice to leave.

>u
Secret Passageway
So, I guess you found my secret room. Either you beat the game, or you found a hack to it. If the first one, good job! Well, you know where to go from here.

* * *

>u
Basement
You see Lola and Lana to the north.

You can see Couch 2 and a Video game concle here.

>d
Secret Passageway
So, I guess you found my secret room. Either you beat the game, or you found a hack to it. If the first one, good job! Well, you know where to go from here.

* * *

Lynn's area
You entered the area where Lynn excercises. You see the Living room to the south, and a couch to the north.

You can see Lynn and Lynn's hair here.

Loud House 'game on'
An Interactive Fiction by Caleb Wilson
Release 1 / Serial number 210525 / Inform 7 build 6M62 (I6/v6.33 lib 6/12N) SD

Lynn's area
You entered the area where Lynn excercises. You see the Living room to the south, and a couch to the north.

You can see Lynn and Lynn's hair here.

>e
Nickolodeon game
You can play the Spongebob game to the north, Alvin and the chipmunks to the south, Henry Danger to the west, and Teenage Mutant Ninja Turtles to the east. Go up twice to leave.

You can see Game Gate here.

>w
Canyon
You are now on the Mountian. You can see Mars to the east.

You can see a rover here.

>e
Mars
You can see a massive iron gate here.

>w
Swellview
Oh no! There's now an alien invasion from Mars! Go down to enter the Man-Cave.

You can see a massive iron gate and Martian here.

* * *

>e
Sewer
You are in the sewer. You see the City above you.

You can see Locked safe 6 (closed), Leo's sword and Mike's nun-chucks here.

>take sword
Taken.

>i
You are carrying:
  Leo's sword
  Quarter 4
  Quarter 2
  Quarter 3
  Quarter 1

* * *

>e
Sewer
You are in the sewer. You see the City above you.

You can see Locked safe 6 (closed), Leo's sword and Mike's nun-chucks here.

>u
City
You are in the city. You see a sai target to the east and your sewer under you.

You can see a Guard here.

>e
Target gate
You are in the City. You see Shredder's Castle to the east.

You can see Castle Gate and a sai target here.

>w
City
You are in the city. You see a sai target to the east and your sewer.

You can see a Guard here.

>i
You are carrying:
  Quarter 4
  Quarter 2
  Quarter 3
  Quarter 1

>w
You can't go that way.

* * *

>e
Target gate
You are in the City. You see Shredder's Castle to the east.

You can see Castle Gate and a sai target here.

>e
(first opening Castle Gate)

Shredder's Castle
You are in Shredder's Castle! You see Target gate to the west.

You can see Castle Gate here.

* * *

>take all
Locked safe 6: Taken.
Leo's sword: Taken.
Mike's nun-chucks: Taken.

>u
City
You are in the city. You see a sai target to the east and your sewer under you.

You can see a Guard here.

>throw mike's nun-chucks at Guard
You knock him out and win your sai back.

You aren't holding Mike's nun-chucks.

>i
You are carrying:
  Raph's sai
  Leo's sword
  Locked safe 6 (closed and locked)
  Quarter 4
  Quarter 2
  Quarter 3
  Quarter 1

>e
Target gate
You are in the City. You see Shredder's Castle to the east.

You can see Castle Gate and a sai target here.

>throw sai at target
(Raph's sai at the sai target)
You throw the sai and hit the target, scoring the key to the gate!

You aren't holding Raph's sai.

>i
You are carrying:
  a Skull Key
  Leo's sword
  Locked safe 6 (closed and locked)
  Quarter 4
  Quarter 2
  Quarter 3
  Quarter 1

>unlock Castle Gate
What do you want to unlock Castle Gate with?

>the Skull Key
You unlock Castle Gate.

>e
(first opening Castle Gate)

Shredder's Castle
You are in Shredder's Castle! You see Target gate to the west.

You can see Castle Gate here.

>lock Castle Gate
What do you want to lock Castle Gate with?

>the Skull Key
First you would have to close Castle Gate.

* * *

>give gamer passes to owner
You can't use multiple objects with that verb.

>give gamer passes to owner
You can't use multiple objects with that verb.

* * *

>n
video game shop
You are in the video game shop. Here you can buy that video game + collectable rare cards for just $45!

You can see an owner and Locked safe 4 (closed) here.

>give gamer pass to owner
Which do you mean, Gamer Pass 4, Gamer Pass 3, Gamer Pass 2 or Gamer Pass 1?

>gamer pass 1
the owner says, "I see you've played your new game." He hands you a game key. "This should unlock a secret level. It is below the menu."

* * *

>n
video game shop
You are in the video game shop. Here you can buy that video game + collectable rare cards for just $45!

You can see an owner and Locked safe 4 (closed) here.

>give passes to owner
You can't use multiple objects with that verb.

>i
You are carrying:
  Gamer Pass 4
  Gamer Pass 3
  Gamer Pass 2
  Gamer Pass 1

>give pass to owner
Which do you mean, Gamer Pass 4, Gamer Pass 3, Gamer Pass 2 or Gamer Pass 1?

>give gamer pass 1 to owner
the owner says, "I see you've played your new game." He hands you a game key. "This should unlock a secret level. It is below the menu."

>undo
video game shop
[Previous turn undone.]

* * *

>n
video game shop
You are in the video game shop. Here you can buy that video game + collectable rare cards for just $45!

You can see an owner and Locked safe 4 (closed) here.

>give gamerpasses to owner
the owner says, "I see you've played your new game." He hands you a game key. "This should unlock a secret level. It is below the menu."

* * *

>give game passes to owner
You can't see any such thing.

>i
You are carrying:
  Gamer Pass 4
  Gamer Pass 3
  Gamer Pass 2
  Gamer Pass 1

>give gamer passes to owner
the owner says, "I see you've played your new game." He hands you a game key. "This should unlock a secret level. It is below the menu."

* * *

>give $45 to owner
"Thank you for buying from Royal Woods Video Game shop," said the owner. "oh, and don't forget that you can play your video game in the room under the room under the basement."

You aren't holding $45.

>x collectable cards
You see nothing special about collectable cards.

>cancel collectable cards
That's not a verb I recognise.

>drop collectable cards
Dropped.

>stop picture
That's not a verb I recognise.

* * *

>x lola
She is wearing a pink dress and a tiara.

>l
South Living room
You see Living room to the north and the basement stairs to the south.

You can see Lola and Lana here.

>n
Living room
You are in the Living room. You see Lynn to the north, Lola and Lana to the south, stairs to the west, and the exit to the east.

>s
South Living room
You see Living room to the north and the basement stairs to the south.

You can see Lola and Lana here.

>e
You can't go that way.

* * *

>w
You can't go that way.

>n
Living room
You are in the Living room. You see Lynn to the north, Lola and Lana to the south, stairs to the west, and the exit to the east.

* * *

>s
South Living room
You see Living room to the north and the basement stairs to the south.

You can see Lola and Lana here.

>n
Living room
You are in the Living room. You see Lynn to the north, Lola and Lana to the south, stairs to the west, and the exit to the east.

>x lana
You can't see any such thing.

* * *

>x lola
She is wearing a pink dress and a tiara.

>i
You are carrying:
  Gamer Pass 4
  Gamer Pass 3
  Gamer Pass 2
  Gamer Pass 1

>x cards
You can't see any such thing.

>restart
Are you sure you want to restart?

>y
South Living room
You see Living room to the north and the basement stairs to the south.

You can see Lola and Lana here.

Man-cave
You can leave the Man-cave by going up.

You can see a space key here.

Loud House 'game on'
An Interactive Fiction by Caleb Wilson
Release 1 / Serial number 210511 / Inform 7 build 6M62 (I6/v6.33 lib 6/12N) SD

Man-cave
You can leave the Man-cave by going up.

You can see a space key here.

>e
Nickolodeon game
You can play the Spongebob game to the north, Alvin and the chipmunks to the south, Henry Danger to the west, and Teenage Mutant Ninja Turtles to the east. Go up twice to leave.

You can see Game Gate here.

* * *

>e
Royal Woods Main Street
You can see a video game shop to the north, your house to the west, and the schools to the south.

>d
You can't go that way.

>s
Royal Woods School Grounds
These bullies come to stop you from entering unless you give them money. You see the inside of the school to the south, and Royal Woods Main Street to the north.

You can see Bully and Locked safe 3 (closed) here.

* * *

>n
video game shop
You are in the video game shop. Here you can buy that video game + collectable rare cards for just $45!

You can see an owner and Locked safe 4 (closed) here.

>i
You are carrying:
  $45
  Gamer Pass 4
  Gamer Pass 3
  Gamer Pass 2
  Gamer Pass 1

>give $45 to owner
"Thank you for buying from Royal Woods Video Game shop," said the owner. "oh, and don't forget that you can play your video game in the room under the room under the basement."

You aren't holding $45.

>i
You are carrying:
  collectable cards
  Gamer Pass 4
  Gamer Pass 3
  Gamer Pass 2
  Gamer Pass 1

>x cards
You see nothing special about collectable cards.

* * *

>d
Nickolodeon game
You can play the Spongebob game to the north, Alvin and the chipmunks to the south, Henry Danger to the west, and Teenage Mutant Ninja Turtles to the east. Go up twice to leave.

You can see Game Gate here.

I beg your pardon?

>d
(first opening Game Gate)
It seems to be locked.

>u
Secret Passageway
So, I guess you found my secret room. Either you beat the game, or you found a hack to it. If the first one, good job! Well, you know where to go from here.

* * *

>u
Basement
You see Lola and Lana to the north.

You can see Couch 2 and a Video game concle here.

>u
You can't go that way.

* * *

Lynn's area
You entered the area where Lynn excercises. You see the Living room to the south, and a couch to the north.

You can see Lynn and Lynn's hair here.

Loud House 'game on'
An Interactive Fiction by Caleb Wilson
Release 1 / Serial number 210525 / Inform 7 build 6M62 (I6/v6.33 lib 6/12N) SD

Lynn's area
You entered the area where Lynn excercises. You see the Living room to the south, and a couch to the north.

You can see Lynn and Lynn's hair here.

>w
You can't go that way.

>open gate
You open the massive iron gate.

>e
Swellview
Oh no! There's now an alien invasion from Mars! Go down to enter the Man-Cave.

You can see a massive iron gate and Martian here.

>e
You can't go that way.

>w
Mars
You can see a massive iron gate here.

>e
Swellview
Oh no! There's now an alien invasion from Mars! Go down to enter the Man-Cave.

You can see a massive iron gate and Martian here.

>w
Mars
You can see a massive iron gate here.

* * *

>w
You can't go that way.

>w
Valley
You are in the Valley. You see the Canyon to the east.

You can see an Alien Bug here.

>x Alien Bug
Quite a strange creature, really.

* * *

>w
Valley
You are in the Valley. You see the Canyon to the east.

You can see an Alien Bug here.

>take Alien Bug
Taken.

>e
Canyon
You are now on the Mountian. You can see Mars to the east.

You can see a rover here.

>give Alien Bug to rover
You give the Alien Bug to the rover and it says "Oooh! Now I can report it to NASA!" He hands you an Omega Grenade.

You aren't holding the Alien Bug.

>i
You are carrying:
  an Omega Grenade
  Quarter 4
  Quarter 2
  Quarter 3
  Quarter 1

* * *

>w
You can't go that way.

>s
living room
You are in the living room. You see Lynn to the north, Lola and Lana to the south, stairs to the west, and the exit to the east.

* * *

Lynn's area
You entered the area where Lynn excercises. You see the Living room to the south, and a couch to the north.

You can see Lynn and Lynn's hair here.

Loud House 'game on'
An Interactive Fiction by Caleb Wilson
Release 1 / Serial number 210525 / Inform 7 build 6M62 (I6/v6.33 lib 6/12N) SD

Lynn's area
You entered the area where Lynn excercises. You see the Living room to the south, and a couch to the north.

You can see Lynn and Lynn's hair here.

>take rocket key
Taken.

>u
Swellview
Oh no! There's now an alien invasion from Mars! Go down to enter the Man-Cave.

You can see a rocket and Martian here.

>w
(first opening the rocket)
It seems to be locked.

>unlock rocket
What do you want to unlock the rocket key with?

>the rocket
I didn't understand that sentence.

>unlock the rocket
What do you want to unlock the rocket key with?

>unlock the rocket with the rocket key
(the rocket key with the rocket key)
That doesn't seem to be something you can unlock.

* * *

>u
Swellview
Oh no! There's now an alien invasion from Mars! Go down to enter the Man-Cave.

You can see a rocket and Martian here.

>unlock rocket
What do you want to unlock the rocket key with?

>unlock rocket with key
(the rocket key with the rocket key)
That doesn't seem to be something you can unlock.

* * *

Lynn's area
You entered the area where Lynn excercises. You see the Living room to the south, and a couch to the north.

You can see Lynn and Lynn's hair here.

Loud House 'game on'
An Interactive Fiction by Caleb Wilson
Release 1 / Serial number 210525 / Inform 7 build 6M62 (I6/v6.33 lib 6/12N) SD

Lynn's area
You entered the area where Lynn excercises. You see the Living room to the south, and a couch to the north.

You can see Lynn and Lynn's hair here.

>take space key
Taken.

>u
Swellview
Oh no! There's now an alien invasion from Mars! Go down to enter the Man-Cave, or go west to enter the rocket and get to Mars.

You can see a rocket and Martian here.

>unlock rocket
What do you want to unlock the rocket with?

>the space key
You unlock the rocket.

>w
(first opening the rocket)

Mars
You are now on Mars. You can go west to Mount Mars or east to get back to earth.

You can see a rocket here.

>e
Swellview
Oh no! There's now an alien invasion from Mars! Go down to enter the Man-Cave.

You can see a rocket and Martian here.

>w
Mars
You are now on Mars. You can go west to Mount Mars or east to get back to earth.

You can see a rocket here.

* * *

>the space key
You unlock the rocket.

>open rocket
You open the rocket.

>w
Mars
You are now on Mars. You can go west to the Canyon or east to get back to earth.

You can see a rocket and a Translater here.

>w
Canyon
You are now on the Mountian. You can see Mars to the east.

You can see a rover here.

* * *

>w
Mars
You are now on Mars. You can go west to the Canyon or east to get back to earth.

You can see a rocket and a Translater here.

>take Translater
Taken.

>w
Canyon
You are now on the Mountian. You can see Mars to the east.

You can see a rover here.

>give Translater to rover
The rover can now say stuff in english. it says "Oh, Wow! I can speak human language! Hey, I need you to give me this special alien bug so my human controllers can finally stop searching and take me off this planet once and for all!"

You aren't holding the Translater.

* * *

>take space key
Taken.

>i
You are carrying:
  a space key
  Quarter 4
  Quarter 2
  Quarter 3
  Quarter 1

>u
Swellview
Oh no! There's now an alien invasion from Mars! Go down to enter the Man-Cave, or go west to enter the rocket and get to Mars.

You can see a rocket and Martian here.

* * *

>open rocket
You open the rocket.

>w
Mars
You are now on Mars. You can go west to the Canyon or east to get back to earth.

You can see a rocket here.

>w
Canyon
You are now on the Mountian. You can see Mars to the east.

* * *

>take space key
Taken.

>w
You can't go that way.

>u
Swellview
Oh no! There's now an alien invasion from Mars! Go down to enter the Man-Cave, or go west to enter the rocket and get to Mars.

You can see a rocket and Martian here.

* * *

>unlock rocket
What do you want to unlock the rocket with?

>space key
You unlock the rocket.

>open rocket
You open the rocket.

* * *

>w
Canyon
You are now on the Mountian. You can see Mars to the east.

You can see a rover here.

>w
Valley
You are in the Valley. You see the Canyon to the east.

You can see an Alien Bug here.

* * *

>take alien bug
Taken.

>give alien bug to rover
You can't see any such thing.

>e
Canyon
You are now on the Mountian. You can see Mars to the east.

You can see a rover here.

>give alien bug to rover
You give the Alien Bug to the rover and it says "Oooh! Now I can report it to NASA!" He hands you an Omega Grenade.

You aren't holding the Alien Bug.

>e
Mars
You are now on Mars. You can go west to the Canyon or east to get back to earth.

You can see a rocket and a Translater here.

>e
Swellview
Oh no! There's now an alien invasion from Mars! Go down to enter the Man-Cave, or go west to enter the rocket and get to Mars.

You can see a rocket and Martian here.

>throw Omega Grenade at Martian
Martian doesn't seem interested.

* * *

Lynn's area
You entered the area where Lynn excercises. You see the Living room to the south, and a couch to the north.

You can see Lynn and Lynn's hair here.

Loud House 'game on'
An Interactive Fiction by Caleb Wilson
Release 1 / Serial number 210525 / Inform 7 build 6M62 (I6/v6.33 lib 6/12N) SD

Lynn's area
You entered the area where Lynn excercises. You see the Living room to the south, and a couch to the north.

You can see Lynn and Lynn's hair here.

>u
Football Stadium
The Football game is about to start, and guess who your playing against- Lynn! She says "Wow, Lincoln! I didn't know that you were coming to the same football game as me!"

You can see a ball and a Scoring post here.

>w
(first opening the rocket)
It seems to be locked.

>unlock rocket with space key
You can't see any such thing.

>unlock rocket
What do you want to unlock the rocket with?

>the space key
You can't see any such thing.

>w
(first opening the rocket)
It seems to be locked.

* * *

>e
You can't go that way.

>u
You can't go that way.

>d
Man-cave
You can leave the Man-cave by going up.

You can see a space key here.

>take space key
Taken.

* * *

>u
Swellview
Oh no! There's now an alien invasion from Mars! Go down to enter the Man-Cave, or go west to enter the rocket and get to Mars.

You can see a rocket and Martian here.

>w
(first opening the rocket)
It seems to be locked.

>unlock rocket
What do you want to unlock the rocket with?

* * *

>open rocket
You open the rocket.

>w
Mars
You are now on Mars. You can go west to Mount Mars or east to get back to earth.

You can see a rocket here.

* * *

>u
Football Stadium
The Football game is about to start, and guess who your playing against- Lynn! She says "Wow, Lincoln! I didn't know that you were coming to the same football game as me!"

You can see a ball and a Scoring post here.

>u
You can't go that way.

>e
You can't go that way.

* * *

>u
City
You are in the city. You see a sai target to the east and your sewer under you.

You can see a Guard here.

>u
You can't go that way.

>n
You can't go that way.

* * *

>w
You can't go that way.

>d
Sewer
You are in the sewer. You see the City above you.

You can see Locked safe 6 (closed), Leo's sword and Mike's nun-chucks here.

>w
Nickolodeon game
You can play the Spongebob game to the north, Alvin and the chipmunks to the south, Henry Danger to the west, and Teenage Mutant Ninja Turtles to the east. Go up twice to leave.

You can see Game Gate here.

>n
Pineapple house
You can go north.

You can see Gary here.

* * *

>n
Bikini Bottom
you  see your Pineapple house to the south and the Krusty Krab to the north.

You can see Plankton's robot here.

>w
You can't go that way.

* * *

>e
You can't go that way.

>restart
Are you sure you want to restart?

* * *

>give $45 to owner
"Thank you for buying from Royal Woods Video Game shop," said the owner. "oh, and don't forget that you can play your video game in the room under the room under the basement."

You aren't holding $45.

>x cards
Now you have your own background to look at. you can undo to stop looking at it.

>s
Royal Woods Main Street
You can see a video game shop to the north, your house to the west, and the schools to the south.

* * *

Lynn's area
You entered the area where Lynn excercises. You see the Living room to the south, and a couch to the north.

You can see Lynn and Lynn's hair here.

Loud House 'game on'
An Interactive Fiction by Caleb Wilson
Release 1 / Serial number 210525 / Inform 7 build 6M62 (I6/v6.33 lib 6/12N) SD

Lynn's area
You entered the area where Lynn excercises. You see the Living room to the south, and a couch to the north.

You can see Lynn and Lynn's hair here.

>take all
space key: Taken.

* * *

>take all
Alien Bug: Taken.

>e
Canyon
You are now on the Mountian. You can see Mars to the east.

You can see a rover here.

* * *

>e
Mars
You are now on Mars. You can go west to the Canyon or east to get back to earth.

You can see a rocket and a Translater here.

>e
Swellview
Oh no! There's now an alien invasion from Mars! Go down to enter the Man-Cave, or go west to enter the rocket and get to Mars.

You can see a rocket and Marty here.

* * *

>throw omega grenade at marty
You did it! You blew up the alien invaders and saved swellview!

You aren't holding the Omega Grenade.

>i
You are carrying:
  a space key
  Quarter 4
  Quarter 2
  Quarter 3
  Quarter 1

* * *

>space key
You unlock the rocket.

>w
(first opening the rocket)

Mars
You are now on Mars. You can go west to the Canyon or east to get back to earth.

You can see a rocket and a Translater here.

* * *

>throw omega grenade at marty
You did it! You blew up the alien invaders and saved swellview!

You aren't holding the Omega Grenade.

>i
You are carrying:
  Gamer Pass 3
  a space key
  Quarter 4
  Quarter 2
  Quarter 3
  Quarter 1

>e
You can't go that way.

* * *

>e
Nickolodeon game
You can play the Spongebob game to the north, Alvin and the chipmunks to the south, Henry Danger to the west, and Teenage Mutant Ninja Turtles to the east. Go up twice to leave.

You can see Game Gate here.

>n
Pineapple house
You can go north.

You can see Gary here.

* * *

>n
Krusty Krab
You see Bikini Bottom to the south.

You can see mister Krabs, Locked safe 5 (closed) and Krabby Patty dresser (in which is Dollar Bill 2) here.

>take dollar bill 2
Taken.

>give dollar bill 2 to mister krabs
mister Krabs's eyes show dollar sighns and he hands you a Krabby Patty.

You aren't holding Dollar Bill 2.

>w
You can't go that way.

>s
Bikini Bottom
you  see your Pineapple house to the south and the Krusty Krab to the north.

You can see Plankton's robot here.

* * *

>throw krabby patty at plankton's robot
you throw the Krabby Patty at the robot, and you've saved Bikini Bottom!

You aren't holding Krabby Patty.

>i
You are carrying:
  Gamer Pass 1
  Gamer Pass 3
  a space key
  Quarter 4
  Quarter 2
  Quarter 3
  Quarter 1

>s
Pineapple house
You can go north.

You can see Gary here.

* * *

>take computer
Taken.

>d
You can't go that way.

>n
Neighborhood
You can see your house to the north, and The Tree house to the south.

You can see evil robot here.

* * *

>s
Neighborhood
You can see your house to the north, and The Tree house to the south.

You can see evil robot here.

>throw squirt gun at robot
you throw the squirt gun at the robot, and the water tank explodes, getting water into the robots systems, shutting it down.

You aren't holding the squirt gun.

>i
You are carrying:
  Gamer Pass 2
  Gamer Pass 1
  Gamer Pass 3
  a space key
  Quarter 4
  Quarter 2
  Quarter 3
  Quarter 1

>n
Chipmunk house
You can see the exit to the south or you can leave the game by going north.

You can see Dave here.

* * *

>n
Nickolodeon game
You can play the Spongebob game to the north, Alvin and the chipmunks to the south, Henry Danger to the west, and Teenage Mutant Ninja Turtles to the east. Go up twice to leave.

You can see Game Gate here.

>e
Sewer
You are in the sewer. You see the City above you.

You can see Locked safe 6 (closed), Leo's sword and Mike's nun-chucks here.

* * *

>e
Target gate
You are in the City. You see Shredder's Castle to the east.

You can see Castle Gate and a sai target here.

>w
City
You are in the city. You see a sai target to the east and your sewer under you.

You can see a Guard here.

* * *

>throw nun-chucks at guard
You knock him out and win your sai back.

You aren't holding Mike's nun-chucks.

>i
You are carrying:
  Raph's sai
  Leo's sword
  Locked safe 6 (closed and locked)
  Gamer Pass 2
  Gamer Pass 1
  Gamer Pass 3
  a space key
  Quarter 4
  Quarter 2
  Quarter 3
  Quarter 1

>n
You can't go that way.

>e
Target gate
You are in the City. You see Shredder's Castle to the east.

You can see Castle Gate and a sai target here.

* * *

>throw sai at sai target
(Raph's sai at the sai target)
You throw the sai and hit the target, scoring the key to the gate!

You aren't holding Raph's sai.

>unlock castle gate
What do you want to unlock Castle Gate with?

>the skull key
You unlock Castle Gate.

>e
(first opening Castle Gate)

Shredder's Castle
You are in Shredder's Castle! You see Target gate to the west.

You can see Castle Gate and Shredder here.

>throw sword at shredder
You throw the sword, and it cuts through Shredder's armor, killing him.

You aren't holding Leo's sword.

>i
You are carrying:
  Gamer Pass 4
  a Skull Key
  Locked safe 6 (closed and locked)
  Gamer Pass 2
  Gamer Pass 1
  Gamer Pass 3
  a space key
  Quarter 4
  Quarter 2
  Quarter 3
  Quarter 1

>w
Target gate
You are in the City. You see Shredder's Castle to the east.

You can see Castle Gate and a sai target here.

* * *

>e
Royal Woods Main Street
You can see a video game shop to the north, your house to the west, and the schools to the south.

>e
You can't go that way.

>n
video game shop
You are in the video game shop. Here you can buy that video game + collectable rare cards for just $45!

You can see an owner and Locked safe 4 (closed) here.

>give Game Pass 1 to owner
You can't see any such thing.

>give pass to owner
Which do you mean, Gamer Pass 4, Gamer Pass 2, Gamer Pass 1 or Gamer Pass 3?

>Gamer Pass 1
Lola is excited and hands you a dollar bill.

>i
You are carrying:
  a Game Key
  a Skull Key
  Locked safe 6 (closed and locked)
  a space key
  Quarter 4
  Quarter 2
  Quarter 3
  Quarter 1

* * *

Lynn's area
You entered the area where Lynn excercises. You see the Living room to the south, and a couch to the north.

You can see Lynn and Lynn's hair here.

Loud House 'game on'
An Interactive Fiction by Caleb Wilson
Release 1 / Serial number 210525 / Inform 7 build 6M62 (I6/v6.33 lib 6/12N) SD

Lynn's area
You entered the area where Lynn excercises. You see the Living room to the south, and a couch to the north.

You can see Lynn and Lynn's hair here.

>take key
Taken.

>e
Nickolodeon game
You can play the Spongebob game to the north, Alvin and the chipmunks to the south, Henry Danger to the west, and Teenage Mutant Ninja Turtles to the east. Go up twice to leave.

>e
Sewer
You are in the sewer. You see the City above you.

You can see Locked safe 6 (closed) and Leo's sword here.

>u
City

* * *

Lynn's area
You entered the area where Lynn excercises. You see the Living room to the south, and a couch to the north.

You can see Lynn and Lynn's hair here.

Loud House 'game on'
An Interactive Fiction by Caleb Wilson
Release 1 / Serial number 210525 / Inform 7 build 6M62 (I6/v6.33 lib 6/12N) SD

Lynn's area
You entered the area where Lynn excercises. You see the Living room to the south, and a couch to the north.

You can see Lynn and Lynn's hair here.

>x game pass 3
You can't see any such thing.

>i
You are carrying:
  Gamer Pass 4
  Gamer Pass 3
  Gamer Pass 2
  Gamer Pass 1

>x gamer pass 3
You earned this by beating the alien invaders. If you give this to the owner of the video game shop, and collect all the other ones, you'll unlock a secret minigame.

* * *

Lynn's area
You entered the area where Lynn excercises. You see the Living room to the south, and a couch to the north.

You can see Lynn and Lynn's hair here.

Loud House 'game on'
An Interactive Fiction by Caleb Wilson
Release 1 / Serial number 210525 / Inform 7 build 6M62 (I6/v6.33 lib 6/12N) SD

Lynn's area
You entered the area where Lynn excercises. You see the Living room to the south, and a couch to the north.

You can see Lynn and Lynn's hair here.

>x cards
You see nothing special about collectable cards.

>i
You are carrying:
  Gamer Pass 4
  Gamer Pass 3
  Gamer Pass 2
  Gamer Pass 1

>e
Nickolodeon game
You can play the Spongebob game to the north, Alvin and the chipmunks to the south, Henry Danger to the west, and Teenage Mutant Ninja Turtles to the east. Go up twice to leave.

You can see Game Gate here.

* * *

>x cards
You see nothing special about collectable cards.

>n
Royal Woods Main Street
You can see a video game shop to the north, your house to the west, and the schools to the south.

!!!

* * *

Lynn's area
You entered the area where Lynn excercises. You see the Living room to the south, and a couch to the north.

You can see Lynn and Lynn's hair here.

Loud House 'game on'
An Interactive Fiction by Caleb Wilson
Release 1 / Serial number 210525 / Inform 7 build 6M62 (I6/v6.33 lib 6/12N) SD

Lynn's area
You entered the area where Lynn excercises. You see the Living room to the south, and a couch to the north.

You can see Lynn and Lynn's hair here.

>squirt
What do you want to squirt?

>squirt me
You are now squirting.

* * *

Lynn's area
You entered the area where Lynn excercises. You see the Living room to the south, and a couch to the north.

You can see Lynn and Lynn's hair here.

Loud House 'game on'
An Interactive Fiction by Caleb Wilson
Release 1 / Serial number 210525 / Inform 7 build 6M62 (I6/v6.33 lib 6/12N) SD

Lynn's area
You entered the area where Lynn excercises. You see the Living room to the south, and a couch to the north.

You can see Lynn and Lynn's hair here.

>squirt me
You teach yourself the meaning of soaked.

>i
You are carrying:
  a squirt gun

>drop gun
Dropped.

>squirt me
You can only squirt if you have a squirt gun, squirt.

* * *

>squirt me
You teach yourself the meaning of soaked.

>l
Your Room
You need money to buy a video game.  You can go north to the hallway.

>n
hallway
Now you are in the hallway.  You can go back south, or west to Lynn's and Lucy's room or east to Lisa's and Lily's room or north for northern hallway.

* * *

>e
Lisa's and Lily's room
Now you are in Lisa's and Lily's room. You see Lisa working on a device and Lily in her crib.

You can see Lisa and Locked safe (closed) here.

>squirt lisa
You teach Lisa the meaning of soaked.

>w
hallway
Now you are in the hallway.  You can go back south, or west to Lynn's and Lucy's room or east to Lisa's and Lily's room or north for northern hallway.

* * *

>w
Lynn's and Lucy's room
Now you are in Lynn's and Lucy's room. Only Lucy is inside. The only way out is back east.

You can see a coffin (in which is Quarter 1) here.

>squirt coffin
You teach the coffin the meaning of soaked.

* * *

Lynn's area
You entered the area where Lynn excercises. You see the Living room to the south, and a couch to the north.

You can see Lynn and Lynn's hair here.

Loud House 'game on'
An Interactive Fiction by Caleb Wilson
Release 1 / Serial number 210525 / Inform 7 build 6M62 (I6/v6.33 lib 6/12N) SD

Lynn's area
You entered the area where Lynn excercises. You see the Living room to the south, and a couch to the north.

You can see Lynn and Lynn's hair here.

>squirt robot
you mercilessly soak the robot. getting water into the robots systems, shutting it down.

>i
You are carrying:
  Gamer Pass 2
  a squirt gun

>drop gun
Dropped.

>squirt robot
You can only squirt if you have a squirt gun, squirt.

>get gun
Taken.

>l
Your Room
You need money to buy a video game.  You can go north to the hallway.

You can see evil robot here.

>squirt gun
You teach the squirt gun the meaning of soaked.

>squirt robot
you mercilessly soak the robot. getting water into the robots systems, shutting it down.

>squirt robot
you mercilessly soak the robot. getting water into the robots systems, shutting it down.

* * *

>i
You are carrying:
  Gamer Pass 2
  a squirt gun

>squirt robot
That robot is already wet enough.

>n
hallway
Now you are in the hallway.  You can go back south, or west to Lynn's and Lucy's room or east to Lisa's and Lily's room or north for northern hallway.

* * *

Lynn's area
You entered the area where Lynn excercises. You see the Living room to the south, and a couch to the north.

You can see Lynn and Lynn's hair here.

Loud House 'game on'
An Interactive Fiction by Caleb Wilson
Release 1 / Serial number 210525 / Inform 7 build 6M62 (I6/v6.33 lib 6/12N) SD

Lynn's area
You entered the area where Lynn excercises. You see the Living room to the south, and a couch to the north.

You can see Lynn and Lynn's hair here.

>drop squirt gun
Dropped.

>squirt robot
you mercilessly soak the robot. getting water into the robots systems, shutting it down.

* * *

Lynn's area
You entered the area where Lynn excercises. You see the Living room to the south, and a couch to the north.

You can see Lynn and Lynn's hair here.

Loud House 'game on'
An Interactive Fiction by Caleb Wilson
Release 1 / Serial number 210525 / Inform 7 build 6M62 (I6/v6.33 lib 6/12N) SD

Lynn's area
You entered the area where Lynn excercises. You see the Living room to the south, and a couch to the north.

You can see Lynn and Lynn's hair here.

>take hair
Taken.

>s
living room
You are in the living room. You see Lynn to the north, Lola and Lana to the south, stairs to the west, and the exit to the east.

>w
far north hall
You are in far north hall. You see Lola's and Lana's room to the west, stairs to the east, and north hall to the south.

>w
Lola's and Lana's room
You enter Lola's and Lana's room. You see far north hall to the east.

You can see a mirror, a teacup, a frog cage and locked safe 2 (closed) here.

>we
That's not a verb I recognise.

>e
far north hall
You are in far north hall. You see Lola's and Lana's room to the west, stairs to the east, and north hall to the south.

>s
north hall
You are in the north hall. you see Lori's and Leni's room to the east, Luan's and Luna's room to the west, hallway to the south, and the far north hall to the north.

>s
hallway
Now you are in the hallway.  You can go back south, or west to Lynn's and Lucy's room, or east to Lisa's and Lily's room or north to the north hall.

>e
Lisa's and Lily's room
Now you are in Lisa's and Lily's room. You see the north hall to the west.

You can see Lisa and a locked safe (closed) here.

>give hair to lisa
Lisa is excited that you gave her Lynn's hair, and she blasts you with the athlete ray. She also gives you a Quarter.

>w
hallway
Now you are in the hallway.  You can go back south, or west to Lynn's and Lucy's room, or east to Lisa's and Lily's room or north to the north hall.

>n
north hall
You are in the north hall. you see Lori's and Leni's room to the east, Luan's and Luna's room to the west, hallway to the south, and the far north hall to the north.

>n
far north hall
You are in far north hall. You see Lola's and Lana's room to the west, stairs to the east, and north hall to the south.

* * *

>e
living room
You are in the living room. You see Lynn to the north, Lola and Lana to the south, stairs to the west, and the exit to the east.

>e
Royal Woods Main Street
You can see a video game shop to the north, your house to the west, and the schools to the south.

* * *

>u
football stadium
The Football game is about to start, and guess who your playing against- Lynn! She says "Wow, Lincoln! I didn't know that you were coming to the same football game as me!"

You can see a ball and a Scoring post here.

>throw ball at scoring post
(first taking the ball)
You throw the ball into the scoring post, and you won the game! The same bully from earlier hands you $500. You decide to split it evenly between your ten sisters- that means $45 each- exactly enough!

You aren't holding the ball.

I beg your pardon?

* * *

Lynn's area
You entered the area where Lynn excercises. You see the Living room to the south, and a couch to the north.

You can see Lynn and Lynn's hair here.

Loud House 'game on'
An Interactive Fiction by Caleb Wilson
Release 1 / Serial number 210525 / Inform 7 build 6M62 (I6/v6.33 lib 6/12N) SD

Lynn's area
You entered the area where Lynn excercises. You see the Living room to the south, and a couch to the north.

You can see Lynn and Lynn's hair here.

>talk to lynn
She says, "I'm trying to excercise for my football game. I've been excercising for about 5 hours streight." You ask her both how she hasn't gotten tired, and why she hasn't used the bathroom for 5 hours. She answers with "1, I don't really get tired unless it's night time, and 2, it's bad luck to use the bathroom before a football game- if I go number 2, I can't be number 1." You see her excercise so hard that a bit of her hair falls off.

>s
living room
You are in the living room. You see Lynn to the north, Lola and Lana to the south, stairs to the west, and the exit to the east.

* * *

>w
far north hall
You are in far north hall. You see Lola's and Lana's room to the west, stairs to the east, and north hall to the south.

>s
north hall
You are in the north hall. you see Lori's and Leni's room to the east, Luan's and Luna's room to the west, hallway to the south, and the far north hall to the north.

>w
Luan's and Luna's room
You are in Luan's and Luna's room. You see the north hall to the east.

You can see Luan, Luna, a puppet and a speaker here.

* * *

>x Luan
She is wearing a dress with a  yellow bottom to it and a squirt flower at the top of the dress.

>x cards
You can't see any such thing.

>e
north hall
You are in the north hall. you see Lori's and Leni's room to the east, Luan's and Luna's room to the west, hallway to the south, and the far north hall to the north.

>n
far north hall
You are in far north hall. You see Lola's and Lana's room to the west, stairs to the east, and north hall to the south.

* * *

>u
football stadium
The Football game is about to start, and guess who your playing against- Lynn! She says "Wow, Lincoln! I didn't know that you were coming to the same football game as me!"

You can see a ball and a Scoring post here.

>give ball to post
(first taking the ball)
You throw the ball into the scoring post, and you won the game! The same bully from earlier hands you $500. You decide to split it evenly between your ten sisters- that means $45 each- exactly enough!

>d
Royal Woods School Grounds
These bullies come to stop you from entering unless you give them money. You see the inside of the school to the south, and Royal Woods Main Street to the north.

You can see Bully and Locked safe 3 (closed) here.

* * *

>n
video game shop
You are in the video game shop. Here you can buy that video game + collectable rare cards for just $45!

You can see an owner and Locked safe 4 (closed) here.

>n
You can't go that way.

>give $45 to owner
"Thank you for buying from Royal Woods Video Game shop," said the owner. "oh, and don't forget that you can play your video game in the room under the room under the basement."

>x cards
Now you have your own background to look at for the rest of the game!

* * *

>s
Royal Woods Main Street
You can see a video game shop to the north, your house to the west, and the schools to the south.

>n
video game shop
You are in the video game shop. Here you can buy that video game + collectable rare cards for just $45!

You can see an owner and Locked safe 4 (closed) here.

* * *

>s
Royal Woods Main Street
You can see a video game shop to the north, your house to the west, and the schools to the south.

>x cards
Now you have your own background to look at for the rest of the game!

>s
Royal Woods School Grounds
These bullies come to stop you from entering unless you give them money. You see the inside of the school to the south, and Royal Woods Main Street to the north.

You can see Bully and Locked safe 3 (closed) here.

>s
You can't go that way.

>w
You can't go that way.

* * *

>e
You can't go that way.

>n
Royal Woods Main Street
You can see a video game shop to the north, your house to the west, and the schools to the south.

>i
You are carrying:
  collectable cards

>squirt
(collectable cards)
You can only squirt if you have a squirt gun, squirt.

>n
video game shop
You are in the video game shop. Here you can buy that video game + collectable rare cards for just $45!

You can see an owner and Locked safe 4 (closed) here.

I beg your pardon?

>s
Royal Woods Main Street
You can see a video game shop to the north, your house to the west, and the schools to the south.

I beg your pardon?

>l
Royal Woods Main Street
You can see a video game shop to the north, your house to the west, and the schools to the south.

* * *

Lynn's area
You entered the area where Lynn excercises. You see the Living room to the south, and a couch to the north.

You can see Lynn and Lynn's hair here.

Loud House 'game on'
An Interactive Fiction by Caleb Wilson
Release 1 / Serial number 210525 / Inform 7 build 6M62 (I6/v6.33 lib 6/12N) SD

Lynn's area
You entered the area where Lynn excercises. You see the Living room to the south, and a couch to the north.

You can see Lynn and Lynn's hair here.

>talk to couch
You can't see any such thing.

>n
North Living room
You can see Lynn to the south.

You can see Couch 1 (in which is Quarter 4) here.

>talk to couch
Testing.

>s
Lynn's area
You entered the area where Lynn excercises. You see the Living room to the south, and a couch to the north.

You can see Lynn and Lynn's hair here.

>talk to lyn
You can't see any such thing.

>talk to lynn
She says, "I'm trying to excercise for my football game. I've been excercising for about 5 hours straight." You ask her both how she hasn't gotten tired, and why she hasn't used the bathroom for 5 hours. She answers with "1, I don't really get tired unless it's night time, and 2, it's bad luck to use the bathroom before a football game- if I go number 2, I can't be number 1." You see her excercise so hard that a bit of her hair falls off.

>l
Lynn's area
You entered the area where Lynn excercises. You see the Living room to the south, and a couch to the north.

You can see Lynn and Lynn's hair here.

>talk to hair
Testing.

>n
North Living room
You can see Lynn to the south.

You can see Couch 1 (in which is Quarter 4) here.

>n
You can't go that way.